Rk,Squad,Comp,# Pl,90s,Tkl,TklW,Def 3rd,Mid 3rd,Att 3rd,Tkl,Att,Tkl%,Past,Blocks,Sh,Pass,Int,Tkl+Int,Clr,Err
1,Alavés,es La Liga,32,38,579,346,261,265,53,255,619,41.2,364,385,114,271,392,971,766,7
2,Amiens,fr Ligue 1,27,28,425,238,194,184,47,201,510,39.4,309,280,87,193,300,725,615,17
3,Angers,fr Ligue 1,26,28,439,279,206,178,55,177,452,39.2,275,229,51,178,267,706,513,8
4,Arsenal,eng Premier League,29,38,584,336,296,217,71,249,612,40.7,363,398,141,257,351,935,754,18
5,Aston Villa,eng Premier League,28,38,523,291,285,174,64,223,597,37.4,374,456,184,272,423,946,928,26
6,Atalanta,it Serie A,30,38,627,351,252,278,97,263,643,40.9,380,396,111,285,418,1045,532,12
7,Athletic Club,es La Liga,26,38,533,324,262,204,67,217,613,35.4,396,339,92,247,373,906,755,7
8,Atlético Madrid,es La Liga,30,38,658,406,293,272,93,283,640,44.2,357,380,108,272,412,1070,729,18
9,Augsburg,de Bundesliga,28,34,534,314,271,215,48,220,563,39.1,343,362,123,239,434,968,778,8
10,Barcelona,es La Liga,28,38,536,323,216,223,97,211,501,42.1,290,313,87,226,342,878,529,16
11,Bayern Munich,de Bundesliga,29,34,500,293,180,222,98,211,503,41.9,292,290,79,211,341,841,382,9
12,Betis,es La Liga,27,38,501,299,276,173,52,221,511,43.2,290,336,119,217,302,803,682,8
13,Bologna,it Serie A,31,38,575,338,270,238,67,226,619,36.5,393,390,125,265,412,987,667,13
14,Bordeaux,fr Ligue 1,26,28,483,284,232,206,45,230,595,38.7,365,237,89,148,302,785,575,13
15,Bournemouth,eng Premier League,27,38,507,299,254,206,47,207,567,36.5,360,439,160,279,475,982,1008,16
16,Brescia,it Serie A,32,38,507,273,256,195,56,226,559,40.4,333,399,170,229,361,868,886,12
17,Brest,fr Ligue 1,24,28,484,282,238,186,60,184,472,39,288,263,82,181,352,836,537,11
18,Brighton,eng Premier League,25,38,641,379,295,269,77,245,642,38.2,397,437,137,300,419,1060,750,15
19,Burnley,eng Premier League,22,38,547,344,238,241,68,240,585,41,345,450,175,275,387,934,901,15
20,Cagliari,it Serie A,33,38,560,338,300,203,57,231,619,37.3,388,445,174,271,337,897,855,13
21,Celta Vigo,es La Liga,30,38,589,357,344,193,52,251,615,40.8,364,345,89,256,396,985,807,12
22,Chelsea,eng Premier League,27,38,638,362,304,258,76,246,604,40.7,358,361,91,270,459,1097,631,14
23,Crystal Palace,eng Premier League,25,38,686,390,367,244,75,316,711,44.4,395,399,135,264,444,1130,856,18
24,Dijon,fr Ligue 1,28,28,516,304,259,208,49,239,548,43.6,309,277,100,177,332,848,596,14
25,Dortmund,de Bundesliga,27,34,529,329,249,214,66,226,509,44.4,283,353,88,265,375,904,463,10
26,Düsseldorf,de Bundesliga,28,34,496,307,244,199,53,200,540,37,340,350,105,245,376,872,610,9
27,Eibar,es La Liga,26,38,567,338,240,228,99,264,607,43.5,343,332,81,251,430,997,692,8
28,Eint Frankfurt,de Bundesliga,27,34,596,377,278,246,72,232,617,37.6,385,403,97,306,376,972,520,5
29,Espanyol,es La Liga,31,38,628,364,303,253,72,257,701,36.7,444,380,96,284,360,988,731,17
30,Everton,eng Premier League,24,38,671,408,328,262,81,282,672,42,390,372,111,261,408,1079,778,13
31,Fiorentina,it Serie A,33,38,571,333,300,205,66,213,628,33.9,415,346,98,248,347,918,719,9
32,Freiburg,de Bundesliga,26,34,431,253,226,162,43,175,497,35.2,322,401,157,244,354,785,810,18
33,Genoa,it Serie A,34,38,551,335,268,210,73,212,589,36,377,410,150,260,385,936,775,16
34,Getafe,es La Liga,30,38,580,341,235,263,82,235,573,41,338,374,60,314,367,947,625,12
35,Granada,es La Liga,27,38,584,349,257,257,70,238,570,41.8,332,375,118,257,383,967,750,10
36,Hellas Verona,it Serie A,30,38,488,290,237,187,64,203,463,43.8,260,361,173,188,398,886,825,10
37,Hertha BSC,de Bundesliga,32,34,555,340,282,221,52,208,521,39.9,313,434,130,304,410,965,794,12
38,Hoffenheim,de Bundesliga,31,34,529,309,283,196,50,239,578,41.3,339,384,121,263,349,878,719,9
39,Inter,it Serie A,29,38,524,287,228,212,84,196,575,34.1,379,371,120,251,370,894,657,12
40,Juventus,it Serie A,30,38,539,318,225,219,95,224,582,38.5,358,374,120,254,370,909,590,14
41,Köln,de Bundesliga,29,34,610,414,293,258,59,249,622,40,373,397,97,300,435,1045,681,5
42,Lazio,it Serie A,27,38,547,311,270,205,72,224,612,36.6,388,404,142,262,378,925,642,9
43,Lecce,it Serie A,30,38,525,293,288,192,45,234,628,37.3,394,395,150,245,383,908,793,30
44,Leganés,es La Liga,29,38,603,357,317,215,71,254,610,41.6,356,320,73,247,418,1021,687,7
45,Leicester City,eng Premier League,24,38,742,432,347,320,75,298,725,41.1,427,420,92,328,423,1165,767,16
46,Levante,es La Liga,29,38,507,288,281,173,53,204,532,38.3,328,317,107,210,331,838,763,14
47,Leverkusen,de Bundesliga,24,34,557,353,239,244,74,263,600,43.8,337,365,71,294,333,890,496,11
48,Lille,fr Ligue 1,25,28,424,237,163,203,58,183,467,39.2,284,263,62,201,278,702,450,9
49,Liverpool,eng Premier League,24,38,550,325,195,243,112,217,588,36.9,371,302,68,234,352,902,634,25
50,Lyon,fr Ligue 1,27,28,492,304,232,193,67,201,442,45.5,241,241,94,147,311,803,540,7
51,M'Gladbach,de Bundesliga,25,34,552,322,254,215,83,228,586,38.9,358,398,106,292,381,933,596,11
52,Mainz 05,de Bundesliga,25,34,576,331,280,233,63,225,542,41.5,317,403,110,293,363,939,724,13
53,Mallorca,es La Liga,32,38,545,338,280,213,52,227,602,37.7,375,360,117,243,376,921,672,9
54,Manchester City,eng Premier League,24,38,514,301,204,210,100,230,605,38,375,292,66,226,352,866,495,21
55,Manchester Utd,eng Premier League,29,38,579,333,267,231,81,254,634,40.1,380,360,99,261,379,958,703,14
56,Marseille,fr Ligue 1,23,28,564,325,246,246,72,235,560,42,325,264,58,206,312,876,533,9
57,Metz,fr Ligue 1,24,28,526,337,295,186,45,213,475,44.8,262,293,97,196,312,838,635,5
58,Milan,it Serie A,32,38,581,345,270,237,74,234,620,37.7,386,353,106,247,419,1000,652,19
59,Monaco,fr Ligue 1,28,28,504,307,231,221,52,235,556,42.3,321,249,70,179,281,785,495,15
60,Montpellier,fr Ligue 1,27,28,449,286,215,190,44,217,570,38.1,353,220,83,137,308,757,520,7
61,Nantes,fr Ligue 1,29,28,548,347,245,249,54,265,550,48.2,285,217,72,145,305,853,512,4
62,Napoli,it Serie A,25,38,487,295,223,183,81,206,540,38.1,334,322,86,236,330,817,464,11
63,Newcastle Utd,eng Premier League,28,38,603,357,364,198,41,273,632,43.2,359,402,152,250,391,994,988,19
64,Nice,fr Ligue 1,31,28,471,279,246,180,45,212,516,41.1,304,280,81,199,343,814,480,13
65,Nîmes,fr Ligue 1,28,28,552,302,235,258,59,249,599,41.6,350,272,75,197,329,881,469,6
66,Norwich City,eng Premier League,30,38,628,379,359,210,59,267,700,38.1,433,453,171,282,397,1025,959,20
67,Osasuna,es La Liga,31,38,613,361,275,267,71,267,617,43.3,350,385,98,287,417,1030,738,19
68,Paderborn 07,de Bundesliga,27,34,632,400,354,221,57,301,722,41.7,421,435,111,324,364,996,747,9
69,Paris S-G,fr Ligue 1,31,27,484,295,191,220,73,191,473,40.4,282,258,57,201,255,739,303,13
70,Parma,it Serie A,25,38,615,348,329,228,58,282,708,39.8,426,423,177,246,394,1009,859,14
71,RB Leipzig,de Bundesliga,29,34,616,361,280,251,85,258,624,41.3,366,397,86,311,364,980,610,16
72,Real Madrid,es La Liga,26,38,586,355,252,253,81,226,595,38,369,367,77,290,381,967,590,13
73,Real Sociedad,es La Liga,27,38,551,321,254,224,73,252,573,44,321,346,79,267,320,871,694,12
74,Reims,fr Ligue 1,26,28,490,324,259,185,46,184,401,45.9,217,228,72,156,325,815,514,8
75,Rennes,fr Ligue 1,26,28,501,296,251,205,45,218,533,40.9,315,277,96,181,272,773,594,7
76,Roma,it Serie A,31,38,493,303,202,203,88,197,503,39.2,306,347,107,240,400,893,644,15
77,Saint-Étienne,fr Ligue 1,31,28,512,318,212,238,62,219,508,43.1,289,267,63,204,376,888,478,15
78,Sampdoria,it Serie A,31,38,584,356,267,224,93,230,605,38,375,397,116,281,397,981,778,5
79,Sassuolo,it Serie A,31,38,553,332,273,211,69,249,556,44.8,307,392,130,262,348,901,666,9
80,Schalke 04,de Bundesliga,29,34,589,361,268,242,79,255,625,40.8,370,474,118,356,407,996,656,15
81,Sevilla,es La Liga,26,38,587,344,274,246,67,261,661,39.5,400,331,94,237,346,933,704,10
82,Sheffield Utd,eng Premier League,26,38,611,377,304,229,78,261,646,40.4,385,336,106,230,420,1031,931,16
83,Southampton,eng Premier League,25,38,706,416,325,287,94,324,793,40.9,469,488,124,364,425,1131,867,21
84,SPAL,it Serie A,34,38,554,327,299,197,58,222,571,38.9,349,390,170,220,394,948,748,15
85,Strasbourg,fr Ligue 1,25,27,472,293,234,193,45,189,403,46.9,214,198,51,147,301,773,436,11
86,Torino,it Serie A,27,38,572,314,266,236,70,212,549,38.6,337,433,160,273,495,1067,875,14
87,Tottenham,eng Premier League,29,38,665,415,331,281,53,253,681,37.2,428,441,148,293,381,1046,894,24
88,Toulouse,fr Ligue 1,30,28,549,346,270,227,52,220,508,43.3,288,252,77,175,320,869,592,13
89,Udinese,it Serie A,25,38,597,340,329,214,54,253,593,42.7,340,434,153,281,375,972,789,13
90,Union Berlin,de Bundesliga,26,34,550,322,265,220,65,213,565,37.7,352,396,124,272,421,971,775,8
91,Valencia,es La Liga,28,38,500,311,270,173,57,232,589,39.4,357,334,130,204,360,860,748,12
92,Valladolid,es La Liga,30,38,568,327,316,204,48,239,672,35.6,433,391,112,279,390,958,749,13
93,Villarreal,es La Liga,25,38,553,323,250,239,64,218,602,36.2,384,362,116,246,339,892,814,12
94,Watford,eng Premier League,26,38,657,369,347,249,61,267,713,37.4,446,396,135,261,424,1081,869,4
95,Werder Bremen,de Bundesliga,30,34,550,345,285,199,66,216,573,37.7,357,369,123,246,423,973,775,11
96,West Ham,eng Premier League,29,38,696,417,374,263,59,300,745,40.3,445,383,117,266,421,1117,789,16
97,Wolfsburg,de Bundesliga,26,34,598,363,277,247,74,241,589,40.9,348,378,87,291,377,975,649,9
98,Wolves,eng Premier League,21,38,646,367,358,227,61,281,685,41,404,378,109,269,437,1083,702,23