Player,Nation,Pos,Squad,Comp,Age,Born,90s,Tkl,TklW,Def 3rd,Mid 3rd,Att 3rd,Tkl,Att,Tkl%,Past,Blocks,Sh,Pass,Int,Tkl+Int,Clr,Err
Max Aarons,eng ENG,DF,Norwich City,eng Premier League,21,2000,32,64,44,49,15,0,37,55,67.3,18,39,19,20,28,92,96,1
Yunis Abdelhamid,ma MAR,DF,Reims,fr Ligue 1,33,1987,33,48,27,34,14,0,16,32,50.0,16,50,25,25,68,116,104,0
Salis Abdul Samed,gh GHA,MF,Clermont Foot,fr Ligue 1,21,2000,27,43,23,25,16,2,20,57,35.1,37,18,1,17,42,85,15,0
Laurent Abergel,fr FRA,MF,Lorient,fr Ligue 1,28,1993,33,110,60,44,53,13,71,166,42.8,95,58,1,57,55,165,13,0
Charles Abi,fr FRA,FW,Saint-Étienne,fr Ligue 1,21,2000,1,0,0,0,0,0,0,1,0.0,1,2,0,2,0,0,0,0
Dickson Abiama,ng NGA,FW,Greuther Fürth,de Bundesliga,22,1998,8,11,7,4,5,2,2,10,20.0,8,12,1,11,4,15,8,0
Matthis Abline,fr FRA,FW,Rennes,fr Ligue 1,18,2003,1,0,0,0,0,0,0,0,,0,2,0,2,0,0,1,0
Tammy Abraham,eng ENG,FW,Roma,it Serie A,23,1997,34,27,13,7,14,6,9,22,40.9,13,17,3,14,5,32,27,0
Luis Abram,pe PER,DF,Granada,es La Liga,25,1996,6,6,3,3,3,0,2,4,50.0,2,6,5,1,5,11,37,1
Francesco Acerbi,it ITA,DF,Lazio,it Serie A,33,1988,28,25,12,15,9,1,12,19,63.2,7,37,28,9,34,59,92,0
Ragnar Ache,de GER,MFFW,Eint Frankfurt,de Bundesliga,23,1998,3,2,0,0,1,1,1,4,25.0,3,3,0,3,0,2,1,0
Mohamed Achi,fr FRA,MF,Nantes,fr Ligue 1,19,2002,0,0,0,0,0,0,0,0,,0,0,0,0,0,0,0,0
Marcos Acuña,ar ARG,DF,Sevilla,es La Liga,29,1991,25,50,29,27,14,9,30,47,63.8,17,22,5,17,14,64,25,1
Che Adams,sct SCO,FW,Southampton,eng Premier League,25,1996,23,13,6,5,5,3,2,16,12.5,14,18,2,16,8,21,18,0
Tyler Adams,us USA,MF,RB Leipzig,de Bundesliga,22,1999,15,23,7,5,16,2,7,25,28.0,18,24,1,23,16,39,19,2
Sargis Adamyan,am ARM,FWMF,Hoffenheim,de Bundesliga,28,1993,4,8,6,3,4,1,3,11,27.3,8,4,0,4,1,9,2,0
Martin Adeline,fr FRA,MFFW,Reims,fr Ligue 1,17,2003,4,15,11,5,8,2,8,16,50.0,8,0,0,0,11,26,6,0
Amine Adli,fr FRA,FWMF,Leverkusen,de Bundesliga,21,2000,14,27,14,10,14,3,8,15,53.3,7,26,2,24,11,38,12,0
Yacine Adli,fr FRA,MFFW,Bordeaux,fr Ligue 1,21,2000,25,43,27,22,14,7,19,68,27.9,49,33,3,30,37,80,11,2
Michel Aebischer,ch SUI,MF,Bologna,it Serie A,24,1997,5,14,5,5,8,1,6,11,54.5,5,4,1,3,6,20,3,0
Felix Afena-Gyan,gh GHA,FWMF,Roma,it Serie A,18,2003,7,10,3,1,6,3,4,7,57.1,3,4,0,4,3,13,0,0
Martin Agirregabiria,es ESP,DF,Alavés,es La Liga,25,1996,18,34,22,17,11,6,18,37,48.6,19,20,3,17,25,59,38,0
Julen Agirrezabala,es ESP,GK,Athletic Club,es La Liga,20,2000,4,0,0,0,0,0,0,0,,0,0,0,0,0,0,2,0
Lucien Agoume,fr FRA,MF,Brest,fr Ligue 1,19,2002,21,51,31,24,20,7,23,45,51.1,22,29,9,20,52,103,27,1
Kevin Agudelo,co COL,MFFW,Spezia,it Serie A,22,1998,14,44,26,13,26,5,7,20,35.0,13,22,0,22,8,52,6,0
Nayef Aguerd,ma MAR,DF,Rennes,fr Ligue 1,25,1996,30,27,18,16,11,0,14,24,58.3,10,24,14,10,24,51,127,1
Sergio Agüero,ar ARG,FW,Barcelona,es La Liga,33,1988,2,1,1,0,0,1,0,2,0.0,2,0,0,0,0,1,0,0
Ruben Aguilar,fr FRA,DF,Monaco,fr Ligue 1,28,1993,24,78,53,39,32,7,43,68,63.2,25,19,4,15,44,122,57,0
Álvaro Aguirre,es ESP,FW,Rayo Vallecano,es La Liga,21,2000,0,0,0,0,0,0,0,0,,0,0,0,0,0,0,0,0
Naouirou Ahamada,fr FRA,MFDF,Stuttgart,de Bundesliga,19,2002,1,1,0,1,0,0,1,3,33.3,2,0,0,0,0,1,0,0
Anel Ahmedhodzic,ba BIH,DF,Bordeaux,fr Ligue 1,22,1999,15,38,26,27,9,2,20,31,64.5,11,16,8,8,22,60,44,0
Jean-Eudes Aholou,ci CIV,MF,Strasbourg,fr Ligue 1,27,1994,11,16,9,4,9,3,5,19,26.3,14,8,1,7,19,35,7,0
Joseph Aidoo,gh GHA,DF,Celta Vigo,es La Liga,25,1995,29,39,26,28,10,1,17,31,54.8,14,23,13,10,38,77,96,3
Ola Aina,ng NGA,DF,Torino,it Serie A,24,1996,16,27,19,11,10,6,15,23,65.2,8,17,3,14,28,55,30,0
Rayan Aït Nouri,fr FRA,DFMF,Wolves,eng Premier League,20,2001,20,64,36,46,15,3,22,44,50.0,22,24,2,22,22,86,39,1
Kristoffer Ajer,no NOR,DF,Brentford,eng Premier League,23,1998,22,29,18,21,6,2,13,21,61.9,8,19,11,8,26,55,74,0
Ludovic Ajorque,re REU,FW,Strasbourg,fr Ligue 1,27,1994,30,36,25,5,19,12,7,40,17.5,33,28,3,25,8,44,31,1
Manuel Akanji,ch SUI,DF,Dortmund,de Bundesliga,26,1995,25,33,23,20,11,2,22,32,68.8,10,26,15,11,35,68,58,0
Carlos Akapo,gq EQG,DF,Cádiz,es La Liga,28,1993,21,43,31,26,15,2,21,37,56.8,16,26,7,19,51,94,61,0
Marley Aké,fr FRA,FWMF,Juventus,it Serie A,20,2001,1,0,0,0,0,0,0,2,0.0,2,0,0,0,1,1,0,0
Nathan Aké,nl NED,DF,Manchester City,eng Premier League,26,1995,10,16,9,7,8,1,6,8,75.0,2,7,5,2,8,24,23,0
Ilias Akhomach,es ESP,FW,Barcelona,es La Liga,17,2004,1,2,0,0,1,1,0,0,,0,0,0,0,0,2,0,0
Maghnes Akliouche,fr FRA,MFFW,Monaco,fr Ligue 1,19,2002,1,2,0,0,2,0,0,1,0.0,1,2,0,2,0,2,0,0
Paul Akouokou,ci CIV,MF,Betis,es La Liga,23,1997,6,14,9,5,7,2,8,12,66.7,4,6,0,6,11,25,6,0
Jean-Daniel Akpa-Akpro,ci CIV,MF,Lazio,it Serie A,28,1992,4,17,10,7,9,1,7,12,58.3,5,4,2,2,2,19,6,0
Kevin Akpoguma,ng NGA,DFFW,Hoffenheim,de Bundesliga,26,1995,17,33,19,16,11,6,16,28,57.1,12,32,2,30,20,53,29,2
David Alaba,at AUT,DF,Real Madrid,es La Liga,29,1992,29,23,13,15,6,2,9,19,47.4,10,26,15,11,22,45,70,1
Sofiane Alakouch,ma MAR,DFMF,Metz,fr Ligue 1,23,1998,2,7,4,3,4,0,2,5,40.0,3,4,0,4,1,8,4,0
Tomás Alarcón,cl CHI,MF,Cádiz,es La Liga,22,1999,16,31,20,17,10,4,10,31,32.3,21,19,7,12,30,61,31,0
Lucas Alario,ar ARG,FW,Leverkusen,de Bundesliga,28,1992,7,6,5,0,2,4,2,5,40.0,3,5,0,5,1,7,6,0
Jordi Alba,es ESP,DF,Barcelona,es La Liga,32,1989,29,47,34,12,26,9,27,47,57.4,20,26,6,20,33,80,41,1
Josué Albert,gf GUF,DF,Clermont Foot,fr Ligue 1,29,1992,0,0,0,0,0,0,0,0,,0,0,0,0,1,1,2,0
Luis Alberto,es ESP,MF,Lazio,it Serie A,28,1992,26,29,17,8,11,10,8,52,15.4,44,32,4,28,13,42,7,0
Raúl Albiol,es ESP,DF,Villarreal,es La Liga,35,1985,27,26,15,20,5,1,14,18,77.8,4,24,15,9,21,47,126,1
Marc Albrighton,eng ENG,FWDF,Leicester City,eng Premier League,31,1989,13,31,19,16,9,6,10,47,21.3,37,15,3,12,14,45,20,0
Paco Alcácer,es ESP,FW,Villarreal,es La Liga,27,1993,9,9,3,2,4,3,1,5,20.0,4,7,0,7,6,15,1,0
Thiago Alcántara,es ESP,MF,Liverpool,eng Premier League,30,1991,17,48,29,14,24,10,10,42,23.8,32,22,2,20,26,74,13,2
Rubén Alcaraz,es ESP,MF,Cádiz,es La Liga,30,1991,12,41,20,14,24,3,22,45,48.9,23,10,2,8,13,54,14,0
Omar Alderete,py PAR,DF,Valencia,es La Liga,24,1996,27,53,34,34,17,2,34,53,64.2,19,30,18,12,35,88,153,0
Iván Alejo,es ESP,MFFW,Cádiz,es La Liga,26,1995,12,33,15,21,10,2,15,44,34.1,29,12,0,12,8,41,17,0
Doğan Alemdar,tr TUR,GK,Rennes,fr Ligue 1,18,2002,12,0,0,0,0,0,0,0,,0,0,0,0,0,0,9,1
Carles Aleñá,es ESP,MF,Getafe,es La Liga,23,1998,26,27,19,11,13,3,9,48,18.8,39,21,2,19,15,42,16,0
Trent Alexander-Arnold,eng ENG,DF,Liverpool,eng Premier League,22,1998,32,40,23,19,13,8,27,60,45.0,33,22,4,18,43,83,40,0
Mircea Alexandru Tirlea,ro ROU,DF,Alavés,es La Liga,21,2000,0,0,0,0,0,0,0,0,,0,0,0,0,0,0,1,0
Mohamed Ali Cho,fr FRA,FW,Angers,fr Ligue 1,17,2004,20,10,5,1,4,5,5,17,29.4,12,17,1,16,8,18,0,1
Alisson,br BRA,GK,Liverpool,eng Premier League,28,1992,36,3,1,3,0,0,3,5,60.0,2,1,0,1,0,3,28,1
Allan,br BRA,MF,Everton,eng Premier League,30,1991,24,74,44,28,39,7,34,105,32.4,71,40,9,31,23,97,39,1
Jim Allevinah,ga GAB,FW,Clermont Foot,fr Ligue 1,26,1995,17,18,13,8,8,2,5,18,27.8,13,11,0,11,6,24,4,0
Dele Alli,eng ENG,MF,Tottenham,eng Premier League,25,1996,7,14,8,10,3,1,5,17,29.4,12,22,5,17,6,20,16,0
Dele Alli,eng ENG,MFFW,Everton,eng Premier League,25,1996,4,7,2,3,4,0,0,4,0.0,4,7,2,5,6,13,10,0
Miguel Almirón,py PAR,MFFW,Newcastle Utd,eng Premier League,27,1994,19,47,29,23,17,7,11,44,25.0,33,14,1,13,20,67,13,0
Marcos Alonso,es ESP,DF,Chelsea,eng Premier League,30,1990,24,41,29,20,12,9,17,36,47.2,19,29,5,24,43,84,53,0
Giorgio Altare,it ITA,DF,Cagliari,it Serie A,22,1998,16,39,28,18,18,3,21,26,80.8,5,17,5,12,30,69,70,0
Hugo Álvarez,es ESP,FW,Celta Vigo,es La Liga,18,2003,0,1,0,1,0,0,0,0,,0,0,0,0,0,1,1,0
Yeray Álvarez,es ESP,DF,Athletic Club,es La Liga,26,1995,21,24,14,15,8,1,10,18,55.6,8,21,16,5,45,69,97,0
Dani Alves,br BRA,DF,Barcelona,es La Liga,38,1983,12,30,19,13,13,4,14,26,53.8,12,10,3,7,11,41,10,2
Steven Alzate,co COL,MF,Brighton,eng Premier League,22,1998,5,10,4,4,5,1,4,7,57.1,3,2,1,1,10,20,10,0
Ibrahim Amadou,fr FRA,DFMF,Metz,fr Ligue 1,28,1993,9,16,8,10,6,0,8,15,53.3,7,4,2,2,14,30,26,0
Emmanuel Amankwaa Akurugu,gh GHA,DF,Getafe,es La Liga,19,2001,1,0,0,0,0,0,0,2,0.0,2,1,0,1,0,0,0,0
Daniel Amartey,gh GHA,DF,Leicester City,eng Premier League,26,1994,24,26,13,19,7,0,19,29,65.5,10,30,22,8,21,47,93,4
Amath,sn SEN,FWMF,Mallorca,es La Liga,25,1996,10,21,11,11,6,4,7,17,41.2,10,12,0,12,7,28,7,0
Jordan Amavi,fr FRA,DF,Nice,fr Ligue 1,27,1994,5,16,10,8,7,1,10,17,58.8,7,3,1,2,15,31,7,0
Jordan Amavi,fr FRA,DFFW,Marseille,fr Ligue 1,27,1994,1,6,5,3,1,2,5,10,50.0,5,1,0,1,1,7,3,0
Wisdom Amey,it ITA,DF,Bologna,it Serie A,15,2005,1,3,2,1,1,1,2,3,66.7,1,2,0,2,3,6,1,0
Kelvin Amian,fr FRA,DF,Spezia,it Serie A,23,1998,29,66,42,43,18,5,30,41,73.2,11,39,21,18,32,98,75,0
Nadiem Amiri,de GER,MFFW,Genoa,it Serie A,24,1996,8,6,4,2,2,2,2,9,22.2,7,7,0,7,0,6,0,0
Nadiem Amiri,de GER,MFFW,Leverkusen,de Bundesliga,24,1996,4,8,4,3,2,3,4,8,50.0,4,4,2,2,5,13,0,0
Ethan Ampadu,wls WAL,MFDF,Venezia,it Serie A,20,2000,25,67,43,37,27,3,24,58,41.4,34,49,19,30,51,118,76,0
Sofyan Amrabat,ma MAR,MF,Fiorentina,it Serie A,24,1996,11,24,13,9,13,2,11,19,57.9,8,25,8,17,5,29,6,1
Joachim Andersen,dk DEN,DF,Crystal Palace,eng Premier League,25,1996,32,30,23,21,9,0,16,27,59.3,11,29,19,10,37,67,125,3
Felipe Anderson,br BRA,FW,Lazio,it Serie A,28,1993,32,71,45,30,33,8,27,99,27.3,72,65,6,59,20,91,16,0
Sebastian Andersson,se SWE,FW,Köln,de Bundesliga,30,1991,14,11,7,0,3,8,3,9,33.3,6,8,0,8,3,14,14,0
Florin Andone,ro ROU,FW,Cádiz,es La Liga,28,1993,2,1,1,1,0,0,0,1,0.0,1,2,0,2,0,1,1,0
Andrés Andrade Cedeño,pa PAN,DF,Arminia,de Bundesliga,22,1998,12,27,16,18,8,1,17,35,48.6,18,16,7,9,19,46,44,0
Benjamin André,fr FRA,MF,Lille,fr Ligue 1,30,1990,31,123,69,49,65,9,51,113,45.1,62,49,11,38,50,173,56,0
Fredrik André Bjørkan,no NOR,DF,Hertha BSC,de Bundesliga,22,1998,4,12,10,7,4,1,7,9,77.8,2,6,2,4,6,18,8,0
Robert Andrich,de GER,MF,Leverkusen,de Bundesliga,26,1994,20,33,17,18,14,1,14,28,50.0,14,19,7,12,31,64,46,0
José Ángel,es ESP,DF,Osasuna,es La Liga,31,1989,12,20,13,9,9,2,9,14,64.3,5,6,1,5,10,30,21,0
Angeliño,es ESP,DF,RB Leipzig,de Bundesliga,24,1997,26,28,21,14,13,1,14,30,46.7,16,24,3,21,29,57,40,0
Ebenezer Annan,gh GHA,DF,Bologna,it Serie A,18,2002,0,1,1,1,0,0,0,0,,0,0,0,0,1,2,1,0
Cristian Ansaldi,ar ARG,DF,Torino,it Serie A,34,1986,8,20,9,11,7,2,10,13,76.9,3,9,1,8,6,26,10,0
Janis Antiste,fr FRA,FW,Spezia,it Serie A,18,2002,9,18,11,6,6,6,5,13,38.5,8,7,1,6,4,22,6,0
Waldemar Anton,de GER,DF,Stuttgart,de Bundesliga,25,1996,29,40,26,22,15,3,19,32,59.4,13,27,16,11,32,72,116,1
Josep Antoni Gayá,es ESP,DF,Mallorca,es La Liga,21,2000,1,0,0,0,0,0,0,0,,0,1,0,1,1,1,3,1
Michail Antonio,jm JAM,FW,West Ham,eng Premier League,31,1990,33,23,17,5,9,9,7,18,38.9,11,19,1,18,3,26,14,0
Christopher Antwi-Adjei,gh GHA,FWMF,Bochum,de Bundesliga,27,1994,13,24,18,7,10,7,7,27,25.9,20,13,0,13,1,25,8,0
Houssem Aouar,fr FRA,MFFW,Lyon,fr Ligue 1,23,1998,28,46,30,9,25,12,27,54,50.0,27,26,1,25,20,66,5,0
Adil Aouchiche,fr FRA,MFFW,Saint-Étienne,fr Ligue 1,19,2002,12,13,6,5,5,3,5,33,15.2,28,18,1,17,17,30,4,0
Dennis Appiah,fr FRA,DF,Nantes,fr Ligue 1,29,1992,23,55,34,35,18,2,28,48,58.3,20,30,13,17,27,82,74,0
Mauro Arambarri,uy URU,MF,Getafe,es La Liga,25,1995,30,62,37,19,32,11,20,68,29.4,48,35,5,30,32,94,18,0
Mattia Aramu,it ITA,MFFW,Venezia,it Serie A,26,1995,23,20,15,5,9,6,8,33,24.2,25,20,2,18,8,28,19,0
Charles Aránguiz,cl CHI,MF,Leverkusen,de Bundesliga,32,1989,18,45,25,18,21,6,22,52,42.3,30,24,4,20,33,78,21,0
Néstor Araujo,mx MEX,DF,Celta Vigo,es La Liga,29,1991,29,22,14,17,5,0,9,21,42.9,12,17,10,7,27,49,105,2
Ronald Araújo,uy URU,DF,Barcelona,es La Liga,22,1999,25,41,23,29,12,0,21,25,84.0,4,37,20,17,23,64,66,1
Cameron Archer,eng ENG,FWMF,Aston Villa,eng Premier League,20,2001,0,0,0,0,0,0,0,0,,0,0,0,0,0,0,0,0
Alphonse Areola,fr FRA,GK,West Ham,eng Premier League,28,1993,1,0,0,0,0,0,0,0,,0,0,0,0,0,0,1,0
Jesús Areso,es ESP,DF,Osasuna,es La Liga,22,1999,2,3,3,2,1,0,0,2,0.0,2,0,0,0,0,3,2,1
Matias Arezo,uy URU,FWMF,Granada,es La Liga,18,2002,2,5,3,2,1,2,4,9,44.4,5,1,0,1,1,6,1,0
Santiago Arias,co COL,DF,Granada,es La Liga,29,1992,5,12,5,8,3,1,4,9,44.4,5,8,4,4,5,17,10,0
Adam Armstrong,eng ENG,FW,Southampton,eng Premier League,24,1997,16,10,4,2,2,6,0,6,0.0,6,13,1,12,3,13,6,0
Stuart Armstrong,sct SCO,MF,Southampton,eng Premier League,29,1992,16,27,19,15,6,6,9,23,39.1,14,10,1,9,8,35,15,0
Marko Arnautović,at AUT,FW,Bologna,it Serie A,32,1989,30,17,9,1,11,5,7,30,23.3,23,13,2,11,7,24,17,0
Maximilian Arnold,de GER,MF,Wolfsburg,de Bundesliga,27,1994,33,37,20,19,16,2,20,50,40.0,30,43,15,28,37,74,55,0
Kepa Arrizabalaga,es ESP,GK,Chelsea,eng Premier League,26,1994,4,0,0,0,0,0,0,0,,0,0,0,0,0,0,4,0
Tolgay Arslan,de GER,MF,Udinese,it Serie A,30,1990,18,35,20,15,16,4,19,50,38.0,31,17,4,13,13,48,23,1
Arthur,br BRA,FW,Fiorentina,it Serie A,23,1998,8,9,5,2,5,2,4,7,57.1,3,4,1,3,1,10,8,0
Santiago Arzamendia,py PAR,MF,Cádiz,es La Liga,23,1998,5,14,6,6,5,3,6,13,46.2,7,6,0,6,4,18,7,0
Takuma Asano,jp JPN,FWMF,Bochum,de Bundesliga,26,1994,18,11,6,3,6,2,5,19,26.3,14,14,1,13,7,18,7,0
Santiago Ascacíbar,ar ARG,MF,Hertha BSC,de Bundesliga,24,1997,26,93,54,50,37,6,38,89,42.7,51,31,6,25,41,134,42,0
Sergio Asenjo,es ESP,GK,Villarreal,es La Liga,32,1989,6,0,0,0,0,0,0,1,0.0,1,0,0,0,1,1,6,0
Alejandro Asensio,es ESP,FW,Rayo Vallecano,es La Liga,20,2000,0,0,0,0,0,0,0,0,,0,0,0,0,0,0,0,0
Marco Asensio,es ESP,FWMF,Real Madrid,es La Liga,25,1996,19,12,8,6,4,2,4,18,22.2,14,8,1,7,12,24,6,1
Harrison Ashby,sct SCO,DF,West Ham,eng Premier League,19,2001,0,0,0,0,0,0,0,0,,0,1,0,1,1,1,1,0
Kristoffer Askildsen,no NOR,MF,Sampdoria,it Serie A,20,2001,8,18,6,7,11,0,9,19,47.4,10,14,7,7,15,33,15,0
Fisnik Asllani,xk KVX,MFFW,Hoffenheim,de Bundesliga,18,2002,0,0,0,0,0,0,0,1,0.0,1,0,0,0,0,0,0,0
Kristjan Asllani,al ALB,MF,Empoli,it Serie A,19,2002,15,18,9,9,8,1,11,29,37.9,18,16,7,9,19,37,15,1
Iago Aspas,es ESP,FW,Celta Vigo,es La Liga,33,1987,34,14,7,1,5,8,4,24,16.7,20,23,2,21,11,25,19,0
Lorenz Assignon,tg TOG,DF,Rennes,fr Ligue 1,21,2000,7,15,10,11,3,1,5,9,55.6,4,3,1,2,11,26,19,0
Simon Asta,de GER,DF,Greuther Fürth,de Bundesliga,20,2001,9,13,6,4,5,4,4,8,50.0,4,14,2,12,8,21,16,0
Youcef Atal,dz ALG,DF,Nice,fr Ligue 1,25,1996,13,29,19,17,10,2,14,25,56.0,11,13,2,11,32,61,21,0
Pierre-Emerick Aubameyang,ga GAB,FW,Arsenal,eng Premier League,32,1989,12,11,5,6,4,1,3,10,30.0,7,12,1,11,0,11,4,0
Pierre-Emerick Aubameyang,ga GAB,FW,Barcelona,es La Liga,32,1989,12,2,2,0,1,1,0,5,0.0,5,9,1,8,2,4,4,0
Emil Audero,it ITA,GK,Sampdoria,it Serie A,24,1997,28,3,1,3,0,0,3,5,60.0,2,0,0,0,2,5,17,2
Tommaso Augello,it ITA,DF,Sampdoria,it Serie A,26,1994,27,36,20,22,8,6,17,29,58.6,12,19,4,15,29,65,68,1
Jean-Kévin Augustin,fr FRA,FWMF,Nantes,fr Ligue 1,24,1997,1,1,0,0,0,1,0,3,0.0,3,1,0,1,0,1,0,0
Ludwig Augustinsson,se SWE,DFFW,Sevilla,es La Liga,27,1994,9,18,14,11,3,4,8,13,61.5,5,10,3,7,5,23,21,0
Serge Aurier,ci CIV,DF,Villarreal,es La Liga,28,1992,11,14,9,11,2,1,4,7,57.1,3,14,7,7,11,25,25,0
Ezequiel Ávila,ar ARG,FWMF,Osasuna,es La Liga,27,1994,21,17,7,6,7,4,7,21,33.3,14,14,2,12,13,30,15,1
Taiwo Awoniyi,ng NGA,FW,Union Berlin,de Bundesliga,23,1997,24,11,7,3,6,2,1,9,11.1,8,11,2,9,2,13,29,0
Ramzi Aya,it ITA,DF,Salernitana,it Serie A,30,1990,2,1,1,1,0,0,1,1,100.0,0,0,0,0,0,1,4,0
Jordan Ayew,gh GHA,FW,Crystal Palace,eng Premier League,29,1991,22,47,30,20,20,7,17,31,54.8,14,33,3,30,15,62,15,0
Kaan Ayhan,tr TUR,DF,Sassuolo,it Serie A,26,1994,15,20,12,14,6,0,7,15,46.7,8,20,14,6,13,33,57,0
Luke Ayling,eng ENG,DF,Leeds United,eng Premier League,29,1991,25,74,42,46,23,5,51,97,52.6,46,46,25,21,28,102,52,1
Karim Azamoum,fr FRA,DF,Troyes,fr Ligue 1,31,1990,4,6,5,4,2,0,3,5,60.0,2,4,2,2,1,7,10,0
Sardar Azmoun,ir IRN,FWMF,Leverkusen,de Bundesliga,26,1995,4,3,1,0,2,1,0,5,0.0,5,2,0,2,0,3,8,0
César Azpilicueta,es ESP,DF,Chelsea,eng Premier League,31,1989,23,51,28,18,27,6,16,35,45.7,19,32,9,23,23,74,65,1
Iddrisu Baba,gh GHA,MF,Mallorca,es La Liga,25,1996,22,57,30,31,23,3,25,43,58.1,18,19,5,14,24,81,34,1
Carlos Bacca,co COL,FW,Granada,es La Liga,34,1986,6,4,4,2,0,2,0,3,0.0,3,5,0,5,1,5,5,0
Daniel Bachmann,at AUT,GK,Watford,eng Premier League,27,1994,12,0,0,0,0,0,0,0,,0,0,0,0,1,1,5,0
Loïc Bade,fr FRA,DF,Rennes,fr Ligue 1,21,2000,11,6,5,4,2,0,3,5,60.0,2,12,10,2,12,18,48,0
Milan Badelj,hr CRO,MF,Genoa,it Serie A,32,1989,32,64,37,25,30,9,34,80,42.5,46,39,7,32,85,149,43,0
Édgar Badía,es ESP,GK,Elche,es La Liga,29,1992,24,0,0,0,0,0,0,0,,0,0,0,0,0,0,16,2
Benoît Badiashile,fr FRA,DF,Monaco,fr Ligue 1,20,2001,20,36,19,21,15,0,14,23,60.9,9,18,12,6,28,64,68,1
Youssouph Badji,sn SEN,FWMF,Brest,fr Ligue 1,19,2001,2,1,0,0,1,0,0,1,0.0,1,0,0,0,0,1,0,0
Miguel Baeza,es ESP,DF,Celta Vigo,es La Liga,21,2000,0,0,0,0,0,0,0,0,,0,0,0,0,0,0,0,0
Nicola Bagnolini,it ITA,GK,Bologna,it Serie A,17,2004,0,0,0,0,0,0,0,0,,0,0,0,0,0,0,0,0
Issa Bah,lu LUX,FW,Venezia,it Serie A,19,2002,0,0,0,0,0,0,0,0,,0,0,0,0,0,0,0,0
Stéphane Bahoken,cm CMR,FW,Angers,fr Ligue 1,29,1992,12,13,8,2,7,4,1,9,11.1,8,15,0,15,3,16,3,0
Leon Bailey,jm JAM,FWMF,Aston Villa,eng Premier League,23,1997,9,17,11,6,8,3,6,13,46.2,7,10,1,9,1,18,2,0
Eric Bailly,ci CIV,DF,Manchester Utd,eng Premier League,27,1994,2,5,4,4,0,1,3,4,75.0,1,4,2,2,3,8,11,0
Dénys Bain,fr FRA,DF,Brest,fr Ligue 1,28,1993,2,3,3,1,2,0,1,1,100.0,0,3,1,2,3,6,5,0
Stefan Bajic,fr FRA,GK,Saint-Étienne,fr Ligue 1,19,2001,6,0,0,0,0,0,0,0,,0,0,0,0,0,0,4,0
Nedim Bajrami,al ALB,MFFW,Empoli,it Serie A,22,1999,23,21,14,5,13,3,4,14,28.6,10,11,0,11,3,24,8,0
Cédric Bakambu,cd COD,FW,Marseille,fr Ligue 1,30,1991,4,2,0,1,0,1,0,3,0.0,3,2,0,2,0,2,1,0
Abdoulaye Bakayoko,fr FRA,DF,Saint-Étienne,fr Ligue 1,18,2002,3,15,9,12,3,0,8,12,66.7,4,5,4,1,11,26,16,0
Tiemoué Bakayoko,fr FRA,MF,Milan,it Serie A,26,1994,6,19,13,9,7,3,5,16,31.3,11,8,1,7,9,28,10,2
Mitchel Bakker,nl NED,DF,Leverkusen,de Bundesliga,21,2000,20,33,22,16,12,5,20,34,58.8,14,13,2,11,23,56,42,3
Ridle Baku,de GER,DFFW,Wolfsburg,de Bundesliga,23,1998,27,62,37,30,24,8,25,65,38.5,40,43,1,42,21,83,52,1
Dilane Bakwa,fr FRA,FWMF,Bordeaux,fr Ligue 1,18,2002,1,1,1,0,1,0,1,2,50.0,1,0,0,0,0,1,1,0
Tommaso Baldanzi,it ITA,FW,Empoli,it Serie A,18,2003,0,0,0,0,0,0,0,0,,0,1,0,1,0,0,0,0
Alejandro Balde,es ESP,DFFW,Barcelona,es La Liga,17,2003,2,2,1,1,0,1,0,0,,0,2,2,0,1,3,1,0
Ibrahima Baldé,fr FRA,FWMF,Lens,fr Ligue 1,18,2003,1,0,0,0,0,0,0,0,,0,0,0,0,0,0,0,0
Keita Baldé,sn SEN,FW,Cagliari,it Serie A,26,1995,14,8,4,1,5,2,1,10,10.0,9,6,0,6,4,12,6,0
Gareth Bale,wls WAL,FW,Real Madrid,es La Liga,32,1989,3,2,1,1,0,1,1,4,25.0,3,2,0,2,2,4,1,0
Mikel Balenziaga,es ESP,DF,Athletic Club,es La Liga,33,1988,23,33,24,15,15,3,25,43,58.1,18,27,4,23,21,54,79,0
Leonardo Balerdi,ar ARG,DF,Marseille,fr Ligue 1,22,1999,11,9,6,9,0,0,5,14,35.7,9,11,4,7,19,28,30,0
Iván Balliu,al ALB,DF,Rayo Vallecano,es La Liga,29,1992,35,45,22,25,11,9,19,31,61.3,12,24,5,19,39,84,64,0
Fodé Ballo-Touré,sn SEN,DF,Milan,it Serie A,24,1997,5,18,14,5,13,0,4,9,44.4,5,6,2,4,3,21,5,0
Folarin Balogun,eng ENG,FW,Arsenal,eng Premier League,20,2001,1,1,1,0,0,1,0,0,,0,1,0,1,0,1,1,0
Abdoulaye Bamba,ci CIV,DFFW,Angers,fr Ligue 1,31,1990,5,6,5,6,0,0,4,11,36.4,7,5,1,4,9,15,13,0
Jonathan Bamba,fr FRA,MFFW,Lille,fr Ligue 1,25,1996,27,30,12,13,9,8,13,36,36.1,23,24,1,23,21,51,10,0
Patrick Bamford,eng ENG,FW,Leeds United,eng Premier League,27,1993,6,1,0,0,1,0,0,3,0.0,3,8,2,6,2,3,8,0
Filippo Bandinelli,it ITA,MF,Empoli,it Serie A,26,1995,22,33,20,10,17,6,15,31,48.4,16,22,5,17,10,43,37,2
Mattia Bani,it ITA,DF,Genoa,it Serie A,27,1993,14,23,13,17,6,0,14,18,77.8,4,19,11,8,20,43,76,0
Simon Banza,fr FRA,FW,Lens,fr Ligue 1,24,1996,1,2,1,0,0,2,0,2,0.0,2,1,0,1,1,3,2,0
Shandon Baptiste,gd GRN,MF,Brentford,eng Premier League,23,1998,10,14,4,9,4,1,6,15,40.0,9,10,0,10,11,25,12,0
Antonín Barák,cz CZE,MFFW,Hellas Verona,it Serie A,26,1994,26,18,8,9,8,1,5,17,29.4,12,32,5,27,6,24,26,0
Barbero,es ESP,FWMF,Osasuna,es La Liga,22,1998,0,0,0,0,0,0,0,0,,0,0,0,0,0,0,1,0
Danilo Barbosa,br BRA,DF,Nice,fr Ligue 1,25,1996,1,0,0,0,0,0,0,0,,0,1,1,0,2,2,10,0
Barcia,es ESP,DF,Granada,es La Liga,20,2000,1,0,0,0,0,0,0,0,,0,1,1,0,1,1,0,1
Bradley Barcola,fr FRA,FWMF,Lyon,fr Ligue 1,18,2002,3,7,4,2,3,2,1,8,12.5,7,7,1,6,2,9,1,1
Melvin Bard,fr FRA,DF,Nice,fr Ligue 1,20,2000,29,59,37,38,17,4,41,63,65.1,22,33,10,23,51,110,56,0
Enis Bardhi,mk MKD,MFFW,Levante,es La Liga,26,1995,19,29,12,12,14,3,12,35,34.3,23,13,2,11,10,39,7,0
Francesco Bardi,it ITA,GK,Bologna,it Serie A,29,1992,2,0,0,0,0,0,0,0,,0,0,0,0,0,0,0,0
Keidi Bare,al ALB,MF,Espanyol,es La Liga,23,1997,17,27,17,14,12,1,11,31,35.5,20,20,10,10,15,42,26,1
Nicolò Barella,it ITA,MF,Inter,it Serie A,24,1997,32,63,42,17,35,11,29,55,52.7,26,26,2,24,21,84,8,2
Kike Barja,es ESP,MFFW,Osasuna,es La Liga,24,1997,10,15,11,4,7,4,8,22,36.4,14,10,1,9,9,24,4,0
Ross Barkley,eng ENG,MFFW,Chelsea,eng Premier League,27,1993,2,0,0,0,0,0,0,1,0.0,1,1,0,1,1,1,0,0
Aymen Barkok,ma MAR,MFDF,Eint Frankfurt,de Bundesliga,23,1998,2,6,2,2,3,1,2,7,28.6,5,4,1,3,5,11,6,0
Ashley Barnes,eng ENG,FW,Burnley,eng Premier League,31,1989,9,11,2,2,7,2,2,9,22.2,7,8,1,7,2,13,5,0
Harvey Barnes,eng ENG,FWMF,Leicester City,eng Premier League,23,1997,23,31,16,9,11,11,7,23,30.4,16,24,1,23,5,36,7,0
Antonio Barragán,es ESP,DF,Elche,es La Liga,34,1987,11,21,14,13,7,1,11,17,64.7,6,5,3,2,17,38,34,0
Leandro Barreiro Martins,lu LUX,MF,Mainz 05,de Bundesliga,21,2000,20,63,32,23,27,13,29,50,58.0,21,23,6,17,32,95,23,0
Ander Barrenetxea,es ESP,FWMF,Real Sociedad,es La Liga,19,2001,6,15,10,9,6,0,8,18,44.4,10,7,0,7,2,17,2,0
Jacob Barrett Laursen,dk DEN,DF,Arminia,de Bundesliga,26,1994,18,16,12,10,6,0,8,21,38.1,13,19,7,12,28,44,43,0
Musa Barrow,gm GAM,FWMF,Bologna,it Serie A,22,1998,24,12,4,4,4,4,6,20,30.0,14,20,1,19,6,18,8,0
Abdourahmane Barry,fr FRA,DF,Greuther Fürth,de Bundesliga,21,2000,2,6,4,3,3,0,5,7,71.4,2,5,2,3,4,10,1,0
Marc Bartra,es ESP,DF,Betis,es La Liga,30,1991,22,39,14,18,17,4,19,35,54.3,16,39,22,17,33,72,105,1
Daniele Baselli,it ITA,MFFW,Torino,it Serie A,29,1992,2,3,3,2,0,1,2,6,33.3,4,0,0,0,1,4,2,0
Daniele Baselli,it ITA,MF,Cagliari,it Serie A,29,1992,3,6,5,3,1,2,1,5,20.0,4,2,0,2,2,8,5,0
Toma Bašić,hr CRO,MF,Lazio,it Serie A,24,1996,11,12,8,3,9,0,5,17,29.4,12,13,4,9,4,16,21,0
Toma Bašić,hr CRO,MF,Bordeaux,fr Ligue 1,24,1996,2,2,2,1,0,1,0,4,0.0,4,4,1,3,2,4,0,0
Amine Bassi,fr FRA,MFFW,Metz,fr Ligue 1,23,1997,2,6,3,2,3,1,1,3,33.3,2,5,0,5,0,6,0,0
Álvaro Bastida,es ESP,MF,Cádiz,es La Liga,17,2004,2,7,4,2,4,1,4,5,80.0,1,1,0,1,3,10,1,0
Alessandro Bastoni,it ITA,DF,Inter,it Serie A,22,1999,26,44,25,28,13,3,17,34,50.0,17,22,12,10,35,79,59,1
Simone Bastoni,it ITA,MFDF,Spezia,it Serie A,24,1996,25,52,34,28,17,7,21,65,32.3,44,38,11,27,30,82,31,0
Lewis Bate,eng ENG,MF,Leeds United,eng Premier League,18,2002,2,1,0,0,0,1,0,8,0.0,8,1,0,1,1,2,1,0
Rodrigo Battaglia,ar ARG,MF,Mallorca,es La Liga,30,1991,13,32,16,13,19,0,15,30,50.0,15,21,10,11,10,42,36,0
Maximilian Bauer,de GER,DF,Greuther Fürth,de Bundesliga,21,2000,19,28,15,17,10,1,11,28,39.3,17,24,14,10,29,57,99,0
Oliver Baumann,de GER,GK,Hoffenheim,de Bundesliga,31,1990,33,0,0,0,0,0,0,3,0.0,3,0,0,0,0,0,19,1
Timo Baumgartl,de GER,DF,Union Berlin,de Bundesliga,25,1996,24,59,28,34,21,4,31,47,66.0,16,27,11,16,37,96,58,0
Julian Baumgartlinger,at AUT,MFFW,Leverkusen,de Bundesliga,33,1988,1,3,1,2,1,0,1,2,50.0,1,1,0,1,2,5,0,0
Christoph Baumgartner,at AUT,MFFW,Hoffenheim,de Bundesliga,21,1999,21,28,15,14,7,7,13,32,40.6,19,24,3,21,8,36,16,0
Jon Bautista,es ESP,MF,Real Sociedad,es La Liga,26,1995,1,3,0,0,3,0,0,1,0.0,1,1,0,1,1,4,1,0
Paul Baysse,fr FRA,MFDF,Bordeaux,fr Ligue 1,33,1988,0,1,1,0,1,0,0,0,,0,0,0,0,0,1,1,0
Noah Joel Sarenren Bazee,ng NGA,MFFW,Augsburg,de Bundesliga,24,1996,3,5,2,2,2,1,3,4,75.0,1,8,2,6,1,6,4,0
Bebé,cv CPV,FW,Rayo Vallecano,es La Liga,31,1990,10,6,5,1,3,2,4,16,25.0,12,18,0,18,3,9,6,0
Ihlas Bebou,tg TOG,FWDF,Hoffenheim,de Bundesliga,27,1994,23,22,14,5,12,5,7,21,33.3,14,20,3,17,12,34,25,0
Rodrigo Becão,br BRA,DF,Udinese,it Serie A,25,1996,35,81,46,49,30,2,34,60,56.7,26,45,20,25,42,123,89,3
Mads Bech Sørensen,dk DEN,DF,Brentford,eng Premier League,22,1999,9,8,7,6,2,0,6,7,85.7,1,9,6,3,6,14,25,0
Sheraldo Becker,sr SUR,FWMF,Union Berlin,de Bundesliga,26,1995,20,9,6,3,4,2,6,18,33.3,12,11,0,11,2,11,4,0
Jan Bednarek,pl POL,DF,Southampton,eng Premier League,25,1996,29,32,15,18,13,1,19,33,57.6,14,48,27,21,72,104,141,0
Donny van de Beek,nl NED,MF,Manchester Utd,eng Premier League,24,1997,1,6,4,4,1,1,1,2,50.0,1,5,1,4,2,8,1,0
Donny van de Beek,nl NED,MF,Everton,eng Premier League,24,1997,5,15,7,8,6,1,6,13,46.2,7,6,2,4,6,21,4,0
Asmir Begović,ba BIH,GK,Everton,eng Premier League,34,1987,3,0,0,0,0,0,0,0,,0,0,0,0,0,0,3,0
Valon Behrami,ch SUI,MFFW,Genoa,it Serie A,36,1985,4,3,1,0,2,1,0,7,0.0,7,4,1,3,1,4,4,0
Kevin Behrens,de GER,FW,Union Berlin,de Bundesliga,30,1991,6,3,2,1,1,1,0,4,0.0,4,3,0,3,3,6,7,0
Youcef Belaïli,dz ALG,MFFW,Brest,fr Ligue 1,29,1992,9,2,1,0,0,2,2,9,22.2,7,5,1,4,7,9,4,0
Vid Belec,si SVN,GK,Salernitana,it Serie A,31,1990,22,0,0,0,0,0,0,0,,0,0,0,0,0,0,9,1
Ishak Belfodil,dz ALG,FW,Hertha BSC,de Bundesliga,29,1992,18,9,6,4,4,1,4,8,50.0,4,9,1,8,5,14,16,0
Haris Belkebla,dz ALG,MF,Brest,fr Ligue 1,27,1994,26,46,23,21,21,4,18,39,46.2,21,26,6,20,48,94,30,1
Stefan Bell,de GER,DF,Mainz 05,de Bundesliga,29,1991,32,54,23,37,16,1,30,63,47.6,33,26,15,11,41,95,112,1
Armel Bella Kotchap,de GER,DF,Bochum,de Bundesliga,19,2001,20,34,20,25,9,0,18,28,64.3,10,23,17,6,43,77,88,2
Raoul Bellanova,it ITA,DFFW,Cagliari,it Serie A,21,2000,28,29,15,14,12,3,6,27,22.2,21,39,8,31,21,50,51,0
Karim Bellarabi,de GER,FWMF,Leverkusen,de Bundesliga,31,1990,8,9,4,4,4,1,3,13,23.1,10,5,0,5,9,18,4,0
Jean-Ricner Bellegarde,fr FRA,MF,Strasbourg,fr Ligue 1,23,1998,26,51,32,21,21,9,17,41,41.5,24,29,4,25,27,78,19,0
Héctor Bellerín,es ESP,DF,Betis,es La Liga,26,1995,22,52,32,29,20,3,31,44,70.5,13,11,2,9,23,75,57,1
Jude Bellingham,eng ENG,MF,Dortmund,de Bundesliga,18,2003,31,52,34,15,31,6,21,53,39.6,32,50,4,46,42,94,32,0
George Bello,us USA,DF,Arminia,de Bundesliga,19,2002,5,7,7,7,0,0,4,4,100.0,0,5,4,1,6,13,11,0
Jeanöel Belocian,fr FRA,DF,Rennes,fr Ligue 1,16,2005,0,0,0,0,0,0,0,0,,0,0,0,0,0,0,0,0
Andrea Belotti,it ITA,FW,Torino,it Serie A,27,1993,15,7,3,2,2,3,3,12,25.0,9,12,4,8,2,9,9,0
Fran Beltrán,es ESP,MF,Celta Vigo,es La Liga,22,1999,29,56,41,27,23,6,28,68,41.2,40,29,5,24,32,88,39,0
Hatem Ben Arfa,fr FRA,FWMF,Lille,fr Ligue 1,34,1987,4,4,2,2,1,1,2,4,50.0,2,3,0,3,0,4,1,0
Salim Ben Seghir,fr FRA,MF,Marseille,fr Ligue 1,18,2003,0,0,0,0,0,0,0,0,,0,0,0,0,0,0,0,0
Wissam Ben Yedder,fr FRA,FW,Monaco,fr Ligue 1,30,1990,28,18,8,1,11,6,6,15,40.0,9,12,1,11,0,18,1,0
Marco Benassi,it ITA,DFMF,Fiorentina,it Serie A,26,1994,2,1,0,1,0,0,1,2,50.0,1,3,0,3,3,4,3,0
Marco Benassi,it ITA,MF,Empoli,it Serie A,26,1994,4,6,3,3,2,1,1,10,10.0,9,4,0,4,3,9,6,0
Darío Benedetto,ar ARG,FWMF,Elche,es La Liga,31,1990,7,5,1,2,2,1,3,6,50.0,3,4,0,4,1,6,1,0
Darío Benedetto,ar ARG,FWMF,Marseille,fr Ligue 1,31,1990,1,0,0,0,0,0,0,0,,0,2,0,2,0,0,0,0
László Bénes,sk SVK,MF,M'Gladbach,de Bundesliga,23,1997,3,5,3,1,3,1,1,6,16.7,5,5,2,3,2,7,5,0
Walter Benítez,ar ARG,GK,Nice,fr Ligue 1,28,1993,37,0,0,0,0,0,0,2,0.0,2,1,0,1,0,0,12,2
Iker Benito,es ESP,FWMF,Osasuna,es La Liga,18,2002,1,2,1,1,0,1,0,1,0.0,1,2,0,2,0,2,2,0
Loris Benito,ch SUI,DF,Bordeaux,fr Ligue 1,29,1992,1,0,0,0,0,0,0,0,,0,0,0,0,1,1,3,1
Pedro Benito,es ESP,FW,Cádiz,es La Liga,21,2000,0,0,0,0,0,0,0,1,0.0,1,0,0,0,0,0,0,0
Filip Benković,hr CRO,DFFW,Udinese,it Serie A,24,1997,0,0,0,0,0,0,0,0,,0,0,0,0,0,0,0,0
Ismaël Bennacer,dz ALG,MF,Milan,it Serie A,23,1997,17,44,30,22,15,7,21,50,42.0,29,20,4,16,25,69,15,0
Keanan Bennetts,eng ENG,FWDF,M'Gladbach,de Bundesliga,22,1999,1,2,0,1,1,0,1,1,100.0,0,1,0,1,0,2,0,0
Saïd Benrahma,dz ALG,FWMF,West Ham,eng Premier League,25,1995,24,28,17,16,9,3,15,38,39.5,23,17,1,16,9,37,8,0
Ramy Bensebaini,dz ALG,DF,M'Gladbach,de Bundesliga,26,1995,22,44,29,25,16,3,29,46,63.0,17,33,7,26,39,83,87,2
Nabil Bentaleb,dz ALG,MF,Angers,fr Ligue 1,26,1994,17,42,24,15,20,7,16,29,55.2,13,24,9,15,28,70,13,0
Rodrigo Bentancur,uy URU,MF,Tottenham,eng Premier League,24,1997,15,36,18,14,14,8,16,32,50.0,16,24,9,15,20,56,35,0
Rodrigo Bentancur,uy URU,MF,Juventus,it Serie A,24,1997,13,32,18,11,18,3,7,20,35.0,13,15,2,13,26,58,15,1
Christian Benteke,be BEL,FW,Crystal Palace,eng Premier League,30,1990,13,3,2,1,2,0,2,6,33.3,4,7,3,4,2,5,33,0
Karim Benzema,fr FRA,FW,Real Madrid,es La Liga,33,1987,29,11,9,5,3,3,2,9,22.2,7,10,0,10,4,15,13,0
Alessandro Berardi,it ITA,GK,Hellas Verona,it Serie A,30,1991,1,0,0,0,0,0,0,0,,0,0,0,0,0,0,0,0
Domenico Berardi,it ITA,FW,Sassuolo,it Serie A,26,1994,31,32,19,9,16,7,15,57,26.3,42,39,2,37,31,63,23,0
Yuri Berchiche,es ESP,DF,Athletic Club,es La Liga,31,1990,11,25,11,10,11,4,7,14,50.0,7,19,6,13,13,38,25,0
Álex Berenguer,es ESP,MF,Athletic Club,es La Liga,26,1995,24,45,26,23,14,8,11,51,21.6,40,40,2,38,16,61,20,0
Bartosz Bereszyński,pl POL,DF,Sampdoria,it Serie A,29,1992,33,64,38,34,25,5,37,80,46.3,43,38,12,26,42,106,73,1
Jóhann Berg Guðmundsson,is ISL,MF,Burnley,eng Premier League,30,1990,12,16,6,7,7,2,5,20,25.0,15,11,2,9,12,28,22,0
Patrick Berg,no NOR,MF,Lens,fr Ligue 1,23,1997,3,14,6,6,8,0,0,4,0.0,4,2,1,1,4,18,3,0
Mitchell van Bergen,nl NED,FWMF,Reims,fr Ligue 1,21,1999,11,8,5,7,0,1,6,15,40.0,9,9,0,9,4,12,7,0
Steven Bergwijn,nl NED,FWMF,Tottenham,eng Premier League,23,1997,6,3,2,2,1,0,1,10,10.0,9,3,0,3,1,4,8,0
Etrit Berisha,al ALB,GK,Torino,it Serie A,32,1989,10,0,0,0,0,0,0,0,,0,0,0,0,0,0,4,0
Valon Berisha,xk KVX,MFFW,Reims,fr Ligue 1,28,1993,5,10,7,2,5,3,2,10,20.0,8,9,0,9,4,14,3,0
Federico Bernardeschi,it ITA,MFFW,Juventus,it Serie A,27,1994,16,16,10,7,4,5,6,13,46.2,7,12,4,8,5,21,15,0
Paul Bernardoni,fr FRA,GK,Angers,fr Ligue 1,24,1997,13,3,2,3,0,0,3,4,75.0,1,0,0,0,0,3,8,1
Paul Bernardoni,fr FRA,GK,Saint-Étienne,fr Ligue 1,24,1997,19,0,0,0,0,0,0,0,,0,0,0,0,0,0,14,2
Juan Bernat,es ESP,DFMF,Paris S-G,fr Ligue 1,28,1993,11,24,14,10,10,4,13,18,72.2,5,8,0,8,8,32,16,0
Dimitry Bertaud,fr FRA,GK,Montpellier,fr Ligue 1,23,1998,9,0,0,0,0,0,0,1,0.0,1,0,0,0,0,0,5,1
Jason Berthomier,fr FRA,MF,Clermont Foot,fr Ligue 1,31,1990,19,29,14,5,17,7,12,34,35.3,22,14,2,12,8,37,4,1
Nicolò Bertola,it ITA,MFDF,Spezia,it Serie A,18,2003,0,3,2,3,0,0,3,4,75.0,1,0,0,0,3,6,1,0
Ryan Bertrand,eng ENG,DF,Leicester City,eng Premier League,31,1989,4,8,5,3,4,1,2,5,40.0,3,8,3,5,1,9,7,0
Daniel Bessa,it ITA,MF,Hellas Verona,it Serie A,28,1993,9,7,2,3,3,1,4,15,26.7,11,13,3,10,5,12,11,0
Beto,gw GNB,FW,Udinese,it Serie A,23,1998,24,21,6,2,14,5,9,19,47.4,10,16,1,15,5,26,25,1
Louis Beyer,de GER,DF,M'Gladbach,de Bundesliga,21,2000,15,47,27,32,14,1,24,44,54.5,20,20,7,13,15,62,55,2
Bartosz Bialek,pl POL,FWDF,Wolfsburg,de Bundesliga,19,2001,2,0,0,0,0,0,0,1,0.0,1,1,0,1,0,0,2,0
Giulian Biancone,fr FRA,DFMF,Troyes,fr Ligue 1,21,2000,26,70,42,44,22,4,40,69,58.0,29,23,8,15,53,123,71,1
Ermin Bičakčić,ba BIH,DF,Hoffenheim,de Bundesliga,31,1990,0,0,0,0,0,0,0,0,,0,0,0,0,0,0,0,0
Mads Bidstrup,dk DEN,MF,Brentford,eng Premier League,20,2001,1,1,0,0,1,0,0,3,0.0,3,0,0,0,1,2,2,0
Pedro Bigas,es ESP,DF,Elche,es La Liga,30,1990,17,24,10,16,8,0,9,20,45.0,11,21,16,5,18,42,77,1
El Bilal Touré,ml MLI,FW,Reims,fr Ligue 1,19,2001,13,13,6,4,6,3,2,7,28.6,5,10,3,7,6,19,19,0
Jean-Claude Billong,cm CMR,DF,Clermont Foot,fr Ligue 1,27,1993,11,17,8,14,1,2,8,11,72.7,3,9,1,8,10,27,35,0
Luis Binks,eng ENG,DF,Bologna,it Serie A,19,2001,7,8,4,7,1,0,4,6,66.7,2,6,5,1,17,25,33,1
Cristiano Biraghi,it ITA,DF,Fiorentina,it Serie A,28,1992,35,37,24,17,15,5,22,53,41.5,31,28,10,18,19,56,31,1
Davide Biraschi,it ITA,DF,Genoa,it Serie A,27,1994,10,31,16,19,9,3,17,24,70.8,7,16,9,7,16,47,26,0
Tom Bischof,de GER,MF,Hoffenheim,de Bundesliga,16,2005,0,0,0,0,0,0,0,0,,0,1,0,1,0,0,1,0
Yves Bissouma,ml MLI,MF,Brighton,eng Premier League,24,1996,24,76,49,35,37,4,21,37,56.8,16,33,3,30,50,126,49,0
Nathan Bitu Mazala,fr FRA,DF,Paris S-G,fr Ligue 1,18,2002,0,0,0,0,0,0,0,0,,0,1,0,1,0,0,0,0
Marco Bizot,nl NED,GK,Brest,fr Ligue 1,30,1991,38,3,1,3,0,0,3,5,60.0,2,1,0,1,0,3,24,1
Bjarki Bjarkason,is ISL,MF,Venezia,it Serie A,21,2000,0,0,0,0,0,0,0,0,,0,0,0,0,0,0,0,0
Blanco,es ESP,MF,Real Madrid,es La Liga,21,2000,0,2,0,1,1,0,0,0,,0,1,1,0,1,3,0,0
Ludovic Blas,fr FRA,MFFW,Nantes,fr Ligue 1,23,1997,33,33,18,7,20,6,15,43,34.9,28,33,3,30,31,64,6,1
Danny Blum,de GER,FW,Bochum,de Bundesliga,30,1991,4,2,1,0,0,2,0,2,0.0,2,4,0,4,2,4,1,0
Myron Boadu,nl NED,FW,Monaco,fr Ligue 1,20,2001,11,9,7,2,3,4,1,5,20.0,4,6,0,6,2,11,1,0
Jérôme Boateng,de GER,DF,Lyon,fr Ligue 1,32,1988,18,20,15,11,9,0,9,17,52.9,8,20,10,10,20,40,73,0
Kevin-Prince Boateng,gh GHA,MFFW,Hertha BSC,de Bundesliga,34,1987,8,6,5,1,4,1,3,9,33.3,6,7,2,5,6,12,11,0
Antonin Bobichon,fr FRA,MFFW,Angers,fr Ligue 1,25,1995,0,1,0,0,1,0,0,0,,0,0,0,0,1,2,0,0
Herbert Bockhorn,de GER,DF,Bochum,de Bundesliga,26,1995,9,24,14,14,7,3,13,21,61.9,8,10,1,9,14,38,18,0
Jean-Paul Boëtius,nl NED,MF,Mainz 05,de Bundesliga,27,1994,20,40,23,18,17,5,22,53,41.5,31,41,3,38,25,65,11,0
Jeremie Boga,ci CIV,FWMF,Atalanta,it Serie A,24,1997,9,7,3,0,4,3,4,6,66.7,2,6,0,6,1,8,3,1
Jeremie Boga,ci CIV,FWMF,Sassuolo,it Serie A,24,1997,7,7,4,1,2,4,2,3,66.7,1,3,0,3,2,9,1,1
Luka Bogdan,hr CRO,DF,Salernitana,it Serie A,25,1996,4,6,3,6,0,0,4,8,50.0,4,3,2,1,6,12,21,0
Emil Bohinen,no NOR,MF,Salernitana,it Serie A,22,1999,8,15,9,4,9,2,10,20,50.0,10,17,3,14,12,27,14,0
Quentin Boisgard,fr FRA,MFFW,Lorient,fr Ligue 1,24,1997,11,19,11,6,10,3,8,17,47.1,9,15,0,15,6,25,5,0
Charles Boli,fr FRA,MFDF,Lens,fr Ligue 1,22,1998,0,2,1,0,2,0,0,0,,0,0,0,0,0,2,0,0
Willy Boly,ci CIV,DF,Wolves,eng Premier League,30,1991,10,25,19,18,7,0,8,15,53.3,7,14,6,8,14,39,35,0
Giacomo Bonaventura,it ITA,MF,Fiorentina,it Serie A,31,1989,25,33,17,12,16,5,21,46,45.7,25,20,2,18,14,47,9,1
Federico Bonazzoli,it ITA,FWMF,Salernitana,it Serie A,24,1997,21,24,12,9,8,7,6,25,24.0,19,17,1,16,6,30,7,0
Tarsis Bonga,de GER,MFFW,Bochum,de Bundesliga,24,1997,0,0,0,0,0,0,0,0,,0,0,0,0,0,0,0,0
Kevin Bonifazi,it ITA,DF,Bologna,it Serie A,25,1996,13,25,16,16,7,2,13,14,92.9,1,22,7,15,16,41,35,0
Solomon Bonnah,nl NED,DF,RB Leipzig,de Bundesliga,17,2003,0,0,0,0,0,0,0,0,,0,1,0,1,1,1,0,0
Leonardo Bonucci,it ITA,DF,Juventus,it Serie A,34,1987,22,14,5,4,10,0,8,13,61.5,5,22,17,5,26,40,82,0
Sebastiaan Bornauw,be BEL,DF,Wolfsburg,de Bundesliga,22,1999,22,30,19,23,5,2,16,25,64.0,9,29,8,21,42,72,97,1
Rafael Borré,co COL,FW,Eint Frankfurt,de Bundesliga,25,1995,26,31,22,4,13,14,7,33,21.2,26,24,4,20,5,36,9,0
Sven Botman,nl NED,DF,Lille,fr Ligue 1,21,2000,25,24,11,13,11,0,12,18,66.7,6,32,21,11,26,50,116,0
Denis Bouanga,ga GAB,FWMF,Saint-Étienne,fr Ligue 1,26,1994,27,46,25,14,13,19,22,63,34.9,41,30,0,30,8,54,34,1
Hicham Boudaoui,dz ALG,MF,Nice,fr Ligue 1,21,1999,18,31,18,15,10,6,13,36,36.1,23,17,4,13,18,49,15,0
Ryad Boudebouz,dz ALG,MFFW,Saint-Étienne,fr Ligue 1,31,1990,25,27,15,11,12,4,12,29,41.4,17,17,2,15,10,37,5,0
Sofiane Boufal,ma MAR,FWMF,Angers,fr Ligue 1,27,1993,26,44,29,19,16,9,18,38,47.4,20,19,2,17,7,51,1,0
Farid Boulaya,dz ALG,MFFW,Metz,fr Ligue 1,28,1993,17,18,10,7,9,2,14,38,36.8,24,8,2,6,12,30,5,0
Yassine Bounou,ma MAR,GK,Sevilla,es La Liga,30,1991,31,0,0,0,0,0,0,0,,0,0,0,0,0,0,11,1
Ismaëlben Boura,fr FRA,DF,Lens,fr Ligue 1,20,2000,1,2,2,1,1,0,0,0,,0,1,1,0,2,4,5,0
Mehdi Bourabia,ma MAR,MF,Spezia,it Serie A,29,1991,3,5,1,2,3,0,3,11,27.3,8,7,6,1,3,8,10,0
Benjamin Bourigeaud,fr FRA,FWMF,Rennes,fr Ligue 1,27,1994,36,46,24,16,18,12,24,67,35.8,43,33,3,30,30,76,44,0
Redwan Bourles,fr FRA,MFFW,Lorient,fr Ligue 1,18,2003,0,0,0,0,0,0,0,0,,0,0,0,0,0,0,0,0
Edoardo Bove,it ITA,MFDF,Roma,it Serie A,19,2002,1,1,1,1,0,0,0,2,0.0,2,1,0,1,1,2,0,0
Jarrod Bowen,eng ENG,FW,West Ham,eng Premier League,24,1996,33,36,20,20,11,5,17,44,38.6,27,29,2,27,21,57,14,0
Dedryck Boyata,be BEL,DF,Hertha BSC,de Bundesliga,30,1990,21,15,13,11,3,1,8,11,72.7,3,17,13,4,17,32,134,1
Lucas Boyé,ar ARG,FW,Elche,es La Liga,25,1996,19,27,13,5,15,7,9,24,37.5,15,24,1,23,2,29,23,0
Domagoj Bradarić,hr CRO,DF,Lille,fr Ligue 1,21,1999,5,11,9,8,2,1,7,12,58.3,5,5,2,3,10,21,7,1
Bilal Brahimi,dz ALG,MF,Nice,fr Ligue 1,21,2000,4,1,1,0,1,0,0,2,0.0,2,1,0,1,2,3,1,0
Bilal Brahimi,dz ALG,FW,Angers,fr Ligue 1,21,2000,4,1,1,0,1,0,0,3,0.0,3,0,0,0,1,2,1,0
Martin Braithwaite,dk DEN,FW,Barcelona,es La Liga,30,1991,3,1,1,0,0,1,0,0,,0,2,0,2,1,2,1,0
Julian Brandt,de GER,MFFW,Dortmund,de Bundesliga,25,1996,23,37,19,13,20,4,17,54,31.5,37,19,2,17,24,61,14,1
Jarrad Branthwaite,eng ENG,DF,Everton,eng Premier League,19,2002,4,4,1,3,1,0,3,8,37.5,5,3,2,1,1,5,20,0
Darko Brašanac,rs SRB,MF,Osasuna,es La Liga,29,1992,27,35,22,19,14,2,14,40,35.0,26,25,8,17,25,60,15,0
Lilian Brassier,fr FRA,DF,Brest,fr Ligue 1,21,1999,25,40,24,23,13,4,10,21,47.6,11,31,21,10,32,72,86,0
Claudio Bravo,cl CHI,GK,Betis,es La Liga,38,1983,16,0,0,0,0,0,0,0,,0,0,0,0,0,0,6,2
Iker Bravo,es ESP,FW,Leverkusen,de Bundesliga,16,2005,0,1,1,0,1,0,0,0,,0,0,0,0,0,1,0,0
Fabian Bredlow,de GER,GK,Stuttgart,de Bundesliga,26,1995,4,0,0,0,0,0,0,0,,0,0,0,0,0,0,1,0
Josip Brekalo,hr CRO,MF,Torino,it Serie A,23,1998,25,9,5,5,1,3,3,21,14.3,18,16,1,15,4,13,7,1
Josip Brekalo,hr CRO,FW,Wolfsburg,de Bundesliga,23,1998,0,0,0,0,0,0,0,0,,0,0,0,0,0,0,0,0
Gleison Bremer,br BRA,DF,Torino,it Serie A,24,1997,32,49,24,27,22,0,18,28,64.3,10,54,23,31,105,154,137,0
Jimmy Briand,fr FRA,FWMF,Bordeaux,fr Ligue 1,35,1985,3,2,0,2,0,0,0,2,0.0,2,0,0,0,1,3,2,0
Yan Brice Eteki,cm CMR,MF,Granada,es La Liga,23,1997,4,6,3,3,2,1,3,7,42.9,4,7,3,4,4,10,6,1
Brian Brobbey,nl NED,FWMF,RB Leipzig,de Bundesliga,19,2002,2,1,0,0,1,0,1,1,100.0,0,1,0,1,0,1,0,0
Armando Broja,al ALB,FW,Southampton,eng Premier League,19,2001,22,12,5,2,7,3,2,9,22.2,7,17,1,16,3,15,11,0
Dylan Bronn,tn TUN,DF,Metz,fr Ligue 1,26,1995,28,47,29,33,13,1,20,31,64.5,11,32,19,13,40,87,78,1
John Brooks,us USA,DF,Wolfsburg,de Bundesliga,28,1993,29,47,25,25,18,4,36,60,60.0,24,33,19,14,41,88,125,1
Daniel Brosinski,de GER,DF,Mainz 05,de Bundesliga,33,1988,4,2,1,1,1,0,1,1,100.0,0,6,0,6,3,5,9,0
Josh Brownhill,eng ENG,MF,Burnley,eng Premier League,25,1995,33,73,37,25,42,6,21,53,39.6,32,37,12,25,68,141,42,1
Marcelo Brozović,hr CRO,MF,Inter,it Serie A,28,1992,33,77,45,34,35,8,34,68,50.0,34,28,10,18,37,114,36,2
Cédric Brunner,ch SUI,DF,Arminia,de Bundesliga,27,1994,24,51,35,29,20,2,25,49,51.0,24,27,10,17,43,94,84,0
Lewis Brunt,eng ENG,MF,Leicester City,eng Premier League,20,2000,0,0,0,0,0,0,0,0,,0,1,0,1,0,0,0,0
Jacob Bruun Larsen,dk DEN,FWMF,Hoffenheim,de Bundesliga,22,1998,9,2,1,1,1,0,0,5,0.0,5,14,3,11,5,7,5,2
Bryan,es ESP,FWMF,Tottenham,eng Premier League,20,2001,1,3,0,1,0,2,1,2,50.0,1,2,0,2,0,3,0,0
Bryan,es ESP,MFFW,Valencia,es La Liga,20,2001,8,13,8,6,3,4,2,13,15.4,11,13,0,13,1,14,4,0
Ante Budimir,hr CRO,FW,Osasuna,es La Liga,30,1991,19,24,10,3,15,6,6,19,31.6,13,22,4,18,3,27,16,0
Emi Buendía,ar ARG,MFFW,Aston Villa,eng Premier League,24,1996,21,38,18,16,13,9,21,51,41.2,30,21,3,18,9,47,11,0
Osman Bukari,gh GHA,FWMF,Nantes,fr Ligue 1,22,1998,11,18,8,7,6,5,8,22,36.4,14,8,0,8,8,26,1,0
Aleksander Buksa,pl POL,FW,Genoa,it Serie A,18,2003,1,0,0,0,0,0,0,1,0.0,1,0,0,0,0,0,1,0
Alessandro Buongiorno,it ITA,DF,Torino,it Serie A,22,1999,13,20,9,9,8,3,9,13,69.2,4,12,6,6,31,51,44,0
Sascha Burchert,de GER,GK,Greuther Fürth,de Bundesliga,31,1989,14,1,1,1,0,0,1,2,50.0,1,0,0,0,0,1,11,1
Delano Burgzorg,nl NED,MF,Mainz 05,de Bundesliga,22,1998,0,1,1,1,0,0,0,1,0.0,1,0,0,0,0,1,0,0
Jonathan Burkardt,de GER,FWMF,Mainz 05,de Bundesliga,21,2000,29,17,8,0,10,7,6,25,24.0,19,31,5,26,8,25,16,0
Roman Bürki,ch SUI,GK,Dortmund,de Bundesliga,30,1990,1,0,0,0,0,0,0,0,,0,0,0,0,0,0,0,0
Dan Burn,eng ENG,DF,Newcastle Utd,eng Premier League,29,1992,16,15,10,10,4,1,7,11,63.6,4,22,14,8,20,35,101,0
Dan Burn,eng ENG,DF,Brighton,eng Premier League,29,1992,11,22,12,13,8,1,6,15,40.0,9,14,10,4,24,46,51,0
Maxime Busi,be BEL,DF,Reims,fr Ligue 1,21,1999,14,26,15,20,5,1,19,36,52.8,17,19,5,14,17,43,28,0
Gianluca Busio,us USA,MF,Venezia,it Serie A,19,2002,22,53,28,27,20,6,28,63,44.4,35,45,13,32,21,74,30,1
Oriol Busquets,es ESP,MF,Clermont Foot,fr Ligue 1,22,1999,2,3,3,0,3,0,2,6,33.3,4,7,4,3,1,4,2,0
Sergio Busquets,es ESP,MF,Barcelona,es La Liga,33,1988,36,93,49,31,48,14,46,83,55.4,37,44,8,36,45,138,31,0
Jack Butland,eng ENG,GK,Crystal Palace,eng Premier League,28,1993,9,0,0,0,0,0,0,0,,0,0,0,0,0,0,1,0
Adrián Butzke,es ESP,FW,Granada,es La Liga,22,1999,0,0,0,0,0,0,0,0,,0,0,0,0,0,0,0,0
Marcin Bułka,pl POL,GK,Nice,fr Ligue 1,21,1999,1,0,0,0,0,0,0,0,,0,0,0,0,0,0,0,0
Jamie Bynoe-Gittens,eng ENG,FW,Dortmund,de Bundesliga,16,2004,2,3,2,0,2,1,2,5,40.0,3,4,1,3,1,4,1,0
Sam Byram,eng ENG,DF,Norwich City,eng Premier League,27,1993,11,24,15,17,6,1,19,27,70.4,8,21,11,10,22,46,48,0
Erick Cabaco,uy URU,DF,Getafe,es La Liga,26,1995,5,2,1,1,1,0,2,5,40.0,3,5,2,3,4,6,10,0
Willy Caballero,ar ARG,GK,Southampton,eng Premier League,39,1981,2,0,0,0,0,0,0,0,,0,0,0,0,0,0,2,1
Rémy Cabella,fr FRA,MFFW,Montpellier,fr Ligue 1,31,1990,4,15,7,4,8,3,5,15,33.3,10,7,0,7,5,20,1,0
Jimmy Cabot,fr FRA,DF,Angers,fr Ligue 1,27,1994,22,81,44,59,15,7,47,83,56.6,36,29,0,29,32,113,30,0
Jovane Cabral,cv CPV,FW,Lazio,it Serie A,23,1998,2,2,1,1,0,1,0,0,,0,1,1,0,1,3,1,0
Leandro Cabrera,uy URU,DF,Espanyol,es La Liga,30,1991,37,37,24,27,10,0,21,34,61.8,13,32,23,9,44,81,222,2
Liberato Cacace,nz NZL,DF,Empoli,it Serie A,20,2000,5,15,6,8,4,3,8,8,100.0,0,7,2,5,8,23,9,0
Martín Cáceres,uy URU,DF,Cagliari,it Serie A,34,1987,9,13,7,5,5,3,4,12,33.3,8,12,3,9,14,27,21,0
Martín Cáceres,uy URU,DF,Levante,es La Liga,34,1987,7,2,2,2,0,0,1,5,20.0,4,2,2,0,11,13,16,1
Anthony Caci,fr FRA,DF,Strasbourg,fr Ligue 1,24,1997,27,65,34,35,24,6,33,55,60.0,22,23,4,19,33,98,49,1
Mathieu Cafaro,fr FRA,MFFW,Reims,fr Ligue 1,24,1997,2,4,2,3,1,0,0,7,0.0,7,2,0,2,3,7,1,0
Yannick Cahuzac,fr FRA,MF,Lens,fr Ligue 1,36,1985,7,5,2,2,3,0,0,5,0.0,5,8,2,6,9,14,12,0
Felipe Caicedo,ec ECU,FW,Genoa,it Serie A,32,1988,3,3,3,0,2,1,0,1,0.0,1,1,0,1,0,3,4,0
Felipe Caicedo,ec ECU,FWDF,Inter,it Serie A,32,1988,0,0,0,0,0,0,0,0,,0,1,0,1,0,0,0,0
Moisés Caicedo,ec ECU,MF,Brighton,eng Premier League,19,2001,7,16,10,7,7,2,5,12,41.7,7,18,4,14,10,26,7,0
Marc-Aurèle Caillard,fr FRA,GK,Metz,fr Ligue 1,27,1994,17,0,0,0,0,0,0,2,0.0,2,0,0,0,2,2,9,1
Jens Cajuste,se SWE,MFFW,Reims,fr Ligue 1,21,1999,4,10,6,6,2,2,6,17,35.3,11,7,2,5,5,15,6,0
Cala,es ESP,DF,Cádiz,es La Liga,31,1989,11,9,4,9,0,0,8,17,47.1,9,12,6,6,12,21,56,0
Davide Calabria,it ITA,DF,Milan,it Serie A,24,1996,24,62,37,31,23,8,37,72,51.4,35,25,5,20,23,85,40,1
Riccardo Calafiori,it ITA,DF,Genoa,it Serie A,19,2002,1,1,0,0,0,1,1,2,50.0,1,2,1,1,2,3,4,0
Riccardo Calafiori,it ITA,DF,Roma,it Serie A,19,2002,2,5,4,2,2,1,1,5,20.0,4,3,0,3,3,8,1,0
Mattia Caldara,it ITA,DF,Venezia,it Serie A,27,1994,30,48,28,30,15,3,20,34,58.8,14,49,37,12,62,110,147,1
Calderón,es ESP,DF,Betis,es La Liga,21,2000,1,2,0,1,0,1,1,3,33.3,2,0,0,0,0,2,2,0
Fernando Calero,es ESP,DF,Espanyol,es La Liga,25,1995,12,17,10,12,5,0,8,13,61.5,5,7,2,5,16,33,63,1
Duje Ćaleta-Car,hr CRO,DF,Marseille,fr Ligue 1,24,1996,23,21,8,15,6,0,11,14,78.6,3,11,7,4,24,45,55,2
Hakan Çalhanoğlu,tr TUR,MF,Inter,it Serie A,27,1994,28,41,23,16,19,6,11,40,27.5,29,29,5,24,25,66,12,0
Daniel Caligiuri,it ITA,DFMF,Augsburg,de Bundesliga,33,1988,22,46,30,17,26,3,27,73,37.0,46,36,5,31,18,64,33,0
José Callejón,es ESP,FW,Fiorentina,it Serie A,34,1987,14,15,6,6,6,3,13,31,41.9,18,6,0,6,3,18,1,1
Lucas Calodat,fr FRA,DF,Saint-Étienne,fr Ligue 1,19,2002,0,0,0,0,0,0,0,0,,0,0,0,0,0,0,0,0
Dominic Calvert-Lewin,eng ENG,FW,Everton,eng Premier League,24,1997,14,11,8,1,6,4,3,8,37.5,5,5,2,3,3,14,12,0
Mahdi Camara,fr FRA,MFDF,Saint-Étienne,fr Ligue 1,23,1998,34,101,57,39,50,12,39,70,55.7,31,44,8,36,58,159,35,1
Mamadou Camara,fr FRA,FW,Troyes,fr Ligue 1,20,2001,0,1,1,1,0,0,0,0,,0,0,0,0,0,1,0,0
Víctor Camarasa,es ESP,MFFW,Betis,es La Liga,27,1994,1,2,1,1,1,0,0,1,0.0,1,2,1,1,2,4,2,0
Eduardo Camavinga,fr FRA,MF,Real Madrid,es La Liga,18,2002,14,52,35,22,20,10,20,38,52.6,18,20,2,18,17,69,14,1
Eduardo Camavinga,fr FRA,MF,Rennes,fr Ligue 1,18,2002,2,4,1,2,1,1,2,5,40.0,3,1,1,0,1,5,3,0
Andrea Cambiaso,it ITA,DF,Genoa,it Serie A,21,2000,20,46,20,28,14,4,18,32,56.3,14,33,8,25,23,69,37,1
José Campaña,es ESP,MF,Levante,es La Liga,28,1993,16,27,16,13,10,4,12,32,37.5,20,13,2,11,21,48,19,1
Chem Campbell,wls WAL,MF,Wolves,eng Premier League,18,2002,0,1,1,0,1,0,0,0,,0,0,0,0,0,1,0,0
Emre Can,de GER,DFMF,Dortmund,de Bundesliga,27,1994,19,36,22,20,16,0,15,30,50.0,15,26,10,16,36,72,40,2
Sergio Canales,es ESP,FWMF,Betis,es La Liga,30,1991,31,24,14,8,12,4,10,35,28.6,25,16,1,15,10,34,12,0
Matteo Cancellieri,it ITA,MFDF,Hellas Verona,it Serie A,19,2002,3,4,4,2,2,0,0,5,0.0,5,2,0,2,1,5,0,0
João Cancelo,pt POR,DF,Manchester City,eng Premier League,27,1994,36,83,54,33,35,15,46,91,50.5,45,25,3,22,59,142,45,1
Fali Candé,gw GNB,DF,Metz,fr Ligue 1,23,1998,11,30,18,13,15,2,13,31,41.9,18,11,2,9,6,36,21,0
Antonio Candreva,it ITA,MFFW,Sampdoria,it Serie A,34,1987,35,27,16,9,11,7,19,55,34.5,36,23,2,21,33,60,19,0
Sergi Canós,es ESP,DFFW,Brentford,eng Premier League,24,1997,23,56,25,32,15,9,33,60,55.0,27,32,3,29,22,78,38,0
Álex Cantero,es ESP,FWMF,Levante,es La Liga,21,2000,7,6,4,2,3,1,1,8,12.5,7,2,0,2,1,7,0,0
Todd Cantwell,eng ENG,FWMF,Norwich City,eng Premier League,23,1998,5,15,13,8,6,1,6,17,35.3,11,2,0,2,3,18,2,0
Ander Capa,es ESP,DF,Athletic Club,es La Liga,29,1992,0,0,0,0,0,0,0,0,,0,0,0,0,0,0,0,0
Pierrick Capelle,fr FRA,MFDF,Angers,fr Ligue 1,34,1987,13,36,24,16,17,3,18,52,34.6,34,12,1,11,16,52,20,0
Leonardo Capezzi,it ITA,MF,Salernitana,it Serie A,26,1995,2,3,1,0,3,0,1,4,25.0,3,8,4,4,0,3,2,0
Étienne Capoue,fr FRA,MF,Villarreal,es La Liga,33,1988,25,44,26,18,23,3,15,28,53.6,13,17,5,12,35,79,51,0
Gianluca Caprari,it ITA,MFFW,Hellas Verona,it Serie A,28,1993,30,43,25,10,22,11,17,51,33.3,34,32,0,32,4,47,7,0
Francesco Caputo,it ITA,FW,Sampdoria,it Serie A,33,1987,31,5,2,1,3,1,1,6,16.7,5,5,0,5,2,7,10,0
Francesco Caputo,it ITA,FW,Sassuolo,it Serie A,33,1987,2,0,0,0,0,0,0,0,,0,0,0,0,0,0,0,0
Maxence Caqueret,fr FRA,MF,Lyon,fr Ligue 1,21,2000,26,73,40,29,36,8,30,80,37.5,50,38,10,28,43,116,26,2
Andrea Carboni,it ITA,DF,Cagliari,it Serie A,20,2001,25,53,24,33,16,4,19,42,45.2,23,42,15,27,27,80,87,0
Isaac Carcelen,es ESP,DFMF,Cádiz,es La Liga,28,1993,17,43,29,29,12,2,28,56,50.0,28,25,6,19,34,77,42,0
Cárdenas,es ESP,GK,Levante,es La Liga,24,1997,24,1,1,1,0,0,0,3,0.0,3,0,0,0,1,2,19,0
Irvin Cardona,fr FRA,FWMF,Brest,fr Ligue 1,23,1997,15,13,7,5,4,4,3,16,18.8,13,10,0,10,5,18,17,0
Igor Carioca,br BRA,DF,Lorient,fr Ligue 1,24,1996,18,27,16,16,8,3,15,43,34.9,28,17,2,15,25,52,28,0
Carlo,es ESP,MF,Villarreal,es La Liga,20,2001,0,0,0,0,0,0,0,0,,0,0,0,0,0,0,0,0
Diego Carlos,br BRA,DF,Sevilla,es La Liga,28,1993,33,35,24,20,13,2,16,24,66.7,8,48,33,15,24,59,120,5
Carmona,es ESP,DF,Sevilla,es La Liga,19,2002,0,0,0,0,0,0,0,0,,0,0,0,0,1,1,0,0
Yannick Carrasco,be BEL,FWMF,Atlético Madrid,es La Liga,27,1993,29,34,19,16,12,6,19,44,43.2,25,26,5,21,19,53,12,2
Guido Carrillo,ar ARG,FW,Elche,es La Liga,30,1991,13,7,4,2,4,1,3,13,23.1,10,9,2,7,1,8,27,0
Dani Carvajal,es ESP,DF,Real Madrid,es La Liga,29,1992,17,43,28,21,15,7,15,26,57.7,11,22,8,14,20,63,38,2
William Carvalho,pt POR,MF,Betis,es La Liga,29,1992,20,49,33,20,25,4,15,40,37.5,25,18,7,11,16,65,20,0
Nicolò Casale,it ITA,DF,Hellas Verona,it Serie A,23,1998,29,46,30,25,19,2,21,37,56.8,16,31,12,19,49,95,95,0
Casemiro,br BRA,MF,Real Madrid,es La Liga,29,1992,29,79,51,45,30,4,30,67,44.8,37,65,19,46,38,117,65,3
Matty Cash,pl POL,DF,Aston Villa,eng Premier League,23,1997,38,89,50,52,34,3,47,78,60.3,31,54,16,38,49,138,100,2
Kiko Casilla,es ESP,GK,Elche,es La Liga,34,1986,14,0,0,0,0,0,0,1,0.0,1,0,0,0,1,1,2,2
Moreto Cassamã,gw GNB,MF,Reims,fr Ligue 1,23,1998,9,12,6,7,4,1,3,19,15.8,16,10,5,5,9,21,5,0
Francesco Cassata,it ITA,MF,Genoa,it Serie A,24,1997,0,0,0,0,0,0,0,0,,0,0,0,0,0,0,0,0
Timothy Castagne,be BEL,DF,Leicester City,eng Premier League,25,1995,24,67,31,38,22,7,27,43,62.8,16,28,9,19,29,96,54,1
Koen Casteels,be BEL,GK,Wolfsburg,de Bundesliga,29,1992,28,0,0,0,0,0,0,1,0.0,1,0,0,0,0,0,9,2
Jean-Charles Castelletto,cm CMR,DF,Nantes,fr Ligue 1,26,1995,28,45,24,27,17,1,25,35,71.4,10,38,27,11,30,75,73,0
Samu Castillejo,es ESP,FWMF,Milan,it Serie A,26,1995,1,4,2,0,2,2,1,8,12.5,7,4,1,3,2,6,1,0
Gonzalo Castro,de GER,MFFW,Arminia,de Bundesliga,34,1987,5,8,3,4,4,0,1,5,20.0,4,3,0,3,3,11,3,0
Jonny Castro,es ESP,DF,Wolves,eng Premier League,27,1994,11,25,15,13,11,1,11,20,55.0,9,14,3,11,13,38,11,0
Gaetano Castrovilli,it ITA,MF,Fiorentina,it Serie A,24,1997,16,25,17,15,6,4,12,23,52.2,11,18,4,14,11,36,6,0
Danilo Cataldi,it ITA,MF,Lazio,it Serie A,26,1994,19,36,17,15,17,4,12,38,31.6,26,24,12,12,17,53,19,1
Catena,es ESP,DF,Rayo Vallecano,es La Liga,26,1994,36,39,23,24,15,0,25,42,59.5,17,26,19,7,30,69,168,3
Craig Cathcart,nir NIR,DF,Watford,eng Premier League,32,1989,27,32,15,25,6,1,16,30,53.3,14,39,29,10,28,60,132,3
Edinson Cavani,uy URU,FW,Manchester Utd,eng Premier League,34,1987,9,4,1,0,3,1,2,8,25.0,6,6,0,6,2,6,8,0
Dani Ceballos,es ESP,MF,Real Madrid,es La Liga,24,1996,3,7,5,4,3,0,1,5,20.0,4,8,2,6,4,11,2,0
Pietro Ceccaroni,it ITA,DF,Venezia,it Serie A,25,1995,35,55,31,33,18,4,25,36,69.4,11,45,32,13,30,85,143,0
Federico Ceccherini,it ITA,DF,Hellas Verona,it Serie A,29,1992,26,32,16,19,10,3,19,33,57.6,14,13,8,5,50,82,76,1
Emil Ceide,no NOR,FWMF,Sassuolo,it Serie A,19,2001,1,1,1,0,1,0,1,2,50.0,1,1,0,1,0,1,0,0
Zeki Çelik,tr TUR,DF,Lille,fr Ligue 1,24,1997,30,64,37,43,17,4,36,63,57.1,27,32,9,23,43,107,62,2
Fabien Centonze,fr FRA,DF,Metz,fr Ligue 1,25,1996,18,33,21,22,9,2,13,32,40.6,19,37,8,29,32,65,51,0
Luca Ceppitelli,it ITA,DF,Cagliari,it Serie A,31,1989,16,23,12,13,10,0,16,27,59.3,11,21,14,7,25,48,54,0
Franco Cervi,ar ARG,MF,Celta Vigo,es La Liga,27,1994,20,73,41,35,22,16,33,77,42.9,44,38,2,36,21,94,19,0
Leonardo César Jardim,br BRA,GK,Lille,fr Ligue 1,26,1995,17,,0,,,,,,,,,,,1,,,
Damir Ceter,co COL,FW,Cagliari,it Serie A,23,1997,0,0,0,0,0,0,0,0,,0,0,0,0,0,0,0,0
Julian Chabot,de GER,DF,Sampdoria,it Serie A,23,1998,5,12,10,8,4,0,8,10,80.0,2,7,4,3,9,21,28,1
Julian Chabot,de GER,DF,Köln,de Bundesliga,23,1998,2,8,3,4,4,0,2,5,40.0,3,4,2,2,3,11,5,1
El Chadaille Bitshiabu,fr FRA,DF,Paris S-G,fr Ligue 1,16,2005,0,0,0,0,0,0,0,0,,0,0,0,0,0,0,2,0
Nassim Chadli,fr FRA,MFDF,Troyes,fr Ligue 1,20,2001,1,5,3,3,0,2,2,4,50.0,2,1,0,1,0,5,0,0
Kayky Chagas,br BRA,FW,Manchester City,eng Premier League,18,2003,0,0,0,0,0,0,0,0,,0,0,0,0,0,0,0,0
Mehdi Chahiri,ma MAR,DF,Strasbourg,fr Ligue 1,25,1996,0,1,1,1,0,0,1,1,100.0,0,0,0,0,0,1,0,0
Trevoh Chalobah,eng ENG,DF,Chelsea,eng Premier League,22,1999,16,40,27,22,18,0,24,31,77.4,7,16,6,10,19,59,43,2
Calum Chambers,eng ENG,DF,Arsenal,eng Premier League,26,1995,2,5,3,3,1,1,3,4,75.0,1,6,3,3,0,5,10,0
Calum Chambers,eng ENG,DF,Aston Villa,eng Premier League,26,1995,9,16,8,10,6,0,4,6,66.7,2,14,8,6,5,21,42,0
Dylan Chambost,fr FRA,MFFW,Troyes,fr Ligue 1,23,1997,8,16,11,6,9,1,4,25,16.0,21,9,2,7,9,25,4,0
Timothy Chandler,us USA,DF,Eint Frankfurt,de Bundesliga,31,1990,14,18,12,10,8,0,11,24,45.8,13,10,3,7,19,37,28,1
Chapela,es ESP,MFFW,Cádiz,es La Liga,22,1999,4,4,2,1,0,3,2,4,50.0,2,6,1,5,4,8,5,0
Brendan Chardonnet,fr FRA,DF,Brest,fr Ligue 1,26,1994,30,44,25,32,11,1,29,40,72.5,11,42,29,13,55,99,141,0
Xavier Chavalerin,fr FRA,MF,Troyes,fr Ligue 1,30,1991,30,49,26,19,25,5,12,55,21.8,43,32,5,27,38,87,36,0
Xavier Chavalerin,fr FRA,MF,Reims,fr Ligue 1,30,1991,2,4,4,2,1,1,1,3,33.3,2,2,0,2,5,9,2,1
Justin Che,us USA,FWDF,Hoffenheim,de Bundesliga,17,2003,1,2,0,1,0,1,1,2,50.0,1,0,0,0,1,3,0,0
Chema,es ESP,MF,Getafe,es La Liga,29,1992,1,0,0,0,0,0,0,1,0.0,1,0,0,0,0,0,0,0
Rayan Cherki,fr FRA,FWMF,Lyon,fr Ligue 1,17,2003,5,6,2,1,3,2,4,9,44.4,5,2,0,2,1,7,0,0
Denis Cheryshev,ru RUS,MFFW,Valencia,es La Liga,30,1990,6,14,5,6,1,7,6,15,40.0,9,9,1,8,9,23,9,0
Daniel Chesters,eng ENG,MF,West Ham,eng Premier League,19,2002,0,0,0,0,0,0,0,0,,0,0,0,0,0,0,0,0
Giorgio Chiellini,it ITA,DF,Juventus,it Serie A,36,1984,15,22,13,17,4,1,7,13,53.8,6,24,18,6,22,44,59,0
Federico Chiesa,it ITA,MFFW,Juventus,it Serie A,23,1997,10,26,19,9,9,8,12,26,46.2,14,7,0,7,4,30,3,0
Ben Chilwell,eng ENG,DF,Chelsea,eng Premier League,24,1996,6,8,3,2,6,0,2,5,40.0,3,7,0,7,4,12,14,1
Chiquinho,pt POR,DFFW,Wolves,eng Premier League,21,2000,2,9,6,4,5,0,4,5,80.0,1,5,0,5,2,11,1,0
Vlad Chiricheș,ro ROU,DF,Sassuolo,it Serie A,31,1989,26,28,15,19,9,0,10,21,47.6,11,34,21,13,41,69,71,4
Pedro Chirivella,es ESP,MF,Nantes,fr Ligue 1,24,1997,29,49,31,14,26,9,25,70,35.7,45,23,2,21,37,86,11,0
Joris Chotard,fr FRA,MF,Montpellier,fr Ligue 1,19,2001,33,59,30,33,23,3,36,78,46.2,42,27,15,12,42,101,56,0
Hamza Choudhury,eng ENG,DFMF,Leicester City,eng Premier League,23,1997,3,9,3,4,4,1,3,5,60.0,2,0,0,0,12,21,10,0
Andreas Christensen,dk DEN,DF,Chelsea,eng Premier League,25,1996,17,14,8,9,4,1,4,7,57.1,3,14,6,8,29,43,57,1
Max Christiansen,de GER,MF,Greuther Fürth,de Bundesliga,24,1996,23,46,25,19,22,5,18,43,41.9,25,52,16,36,68,114,56,0
Carney Chukwuemeka,eng ENG,MFFW,Aston Villa,eng Premier League,17,2003,3,7,1,2,5,0,3,5,60.0,2,3,0,3,2,9,2,1
Samuel Chukwueze,ng NGA,MFFW,Villarreal,es La Liga,22,1999,15,13,9,6,5,2,3,6,50.0,3,7,0,7,5,18,4,0
Víctor Chust,es ESP,DF,Cádiz,es La Liga,21,2000,20,19,10,14,4,1,11,17,64.7,6,20,8,12,16,35,87,0
Riccardo Ciervo,it ITA,MFDF,Sampdoria,it Serie A,19,2002,3,8,3,4,3,1,2,6,33.3,4,1,0,1,2,10,2,0
Jasper Cillessen,nl NED,GK,Valencia,es La Liga,32,1989,16,0,0,0,0,0,0,1,0.0,1,0,0,0,1,1,6,0
Pathé Ciss,sn SEN,MF,Rayo Vallecano,es La Liga,27,1994,12,31,15,20,8,3,12,26,46.2,14,16,6,10,30,61,27,0
Moustapha Cissé,gn GUI,FW,Atalanta,it Serie A,17,2003,0,1,0,0,1,0,0,3,0.0,3,0,0,0,0,1,0,0
Giorgio Cittadini,it ITA,DF,Atalanta,it Serie A,19,2002,0,0,0,0,0,0,0,0,,0,0,0,0,1,1,0,0
Ciaran Clark,ie IRL,DF,Newcastle Utd,eng Premier League,31,1989,11,13,10,4,7,2,9,14,64.3,5,14,11,3,13,26,43,1
Alexis Claude-Maurice,fr FRA,MF,Nice,fr Ligue 1,23,1998,2,2,0,1,0,1,1,4,25.0,3,7,0,7,3,5,1,0
Jonathan Clauss,fr FRA,DF,Lens,fr Ligue 1,28,1992,34,63,34,33,20,10,23,56,41.1,33,43,1,42,73,136,51,0
Carlos Clerc,es ESP,DF,Levante,es La Liga,29,1992,17,35,17,21,10,4,7,19,36.8,12,8,3,5,26,61,32,1
Tom Cleverley,eng ENG,MF,Watford,eng Premier League,31,1989,18,37,20,19,17,1,18,33,54.5,15,23,6,17,18,55,19,3
Nathaniel Clyne,eng ENG,DF,Crystal Palace,eng Premier League,30,1991,15,21,10,11,9,1,10,20,50.0,10,7,2,5,15,36,32,0
Conor Coady,eng ENG,DF,Wolves,eng Premier League,28,1993,37,31,14,23,7,1,16,28,57.1,12,46,40,6,28,59,140,0
Marcus Coco,fr FRA,MFFW,Nantes,fr Ligue 1,25,1996,10,34,14,17,11,6,8,18,44.4,10,11,1,10,10,44,15,0
Coke,es ESP,DF,Levante,es La Liga,34,1987,1,3,2,1,1,1,3,4,75.0,1,1,0,1,2,5,7,0
Séamus Coleman,ie IRL,DF,Everton,eng Premier League,32,1988,30,61,36,35,16,10,33,51,64.7,18,30,11,19,32,93,80,2
Álex Collado,es ESP,MFFW,Granada,es La Liga,22,1999,11,27,12,6,16,5,12,31,38.7,19,28,2,26,6,33,11,0
Ebrima Colley,gm GAM,FWMF,Spezia,it Serie A,21,2000,4,6,1,3,2,1,1,7,14.3,6,8,0,8,3,9,2,0
Omar Colley,gm GAM,DF,Sampdoria,it Serie A,28,1992,31,47,36,32,14,1,22,32,68.8,10,31,19,12,80,127,135,2
Nathan Collins,ie IRL,DF,Burnley,eng Premier League,20,2001,19,37,15,27,8,2,17,27,63.0,10,38,25,13,24,61,83,2
Kingsley Coman,fr FRA,FWDF,Bayern Munich,de Bundesliga,25,1996,15,14,8,1,9,4,5,16,31.3,11,14,0,14,8,22,5,0
Eray Cömert,ch SUI,DF,Valencia,es La Liga,23,1998,5,5,3,4,1,0,3,6,50.0,3,3,2,1,2,7,6,0
Santi Comesaña,es ESP,MF,Rayo Vallecano,es La Liga,24,1996,30,87,56,45,33,9,40,104,38.5,64,46,6,40,33,120,30,0
Diego Conde,es ESP,GK,Getafe,es La Liga,22,1998,0,0,0,0,0,0,0,0,,0,0,0,0,0,0,0,0
Aaron Connolly,ie IRL,FWMF,Brighton,eng Premier League,21,2000,2,0,0,0,0,0,0,1,0.0,1,2,0,2,0,0,0,0
Andrea Consigli,it ITA,GK,Sassuolo,it Serie A,34,1987,37,0,0,0,0,0,0,2,0.0,2,0,0,0,0,0,23,3
Abdu Conté,pt POR,DF,Troyes,fr Ligue 1,23,1998,15,22,12,16,5,1,12,24,50.0,12,12,2,10,4,26,10,0
Andrea Conti,it ITA,DFMF,Sampdoria,it Serie A,27,1994,3,4,2,2,1,1,3,6,50.0,3,4,0,4,7,11,4,0
Andrea Conti,it ITA,DF,Milan,it Serie A,27,1994,0,0,0,0,0,0,0,0,,0,0,0,0,0,0,0,0
Liam Cooper,sct SCO,DF,Leeds United,eng Premier League,29,1991,20,41,23,27,13,1,23,33,69.7,10,29,18,11,43,84,72,2
Lucas Copado,de GER,FW,Bayern Munich,de Bundesliga,17,2004,0,1,0,1,0,0,1,1,100.0,0,0,0,0,0,1,0,0
Diego Coppola,it ITA,DF,Hellas Verona,it Serie A,17,2003,3,8,4,4,4,0,3,3,100.0,0,5,1,4,4,12,5,0
Francis Coquelin,fr FRA,MF,Villarreal,es La Liga,30,1991,9,26,17,9,11,6,11,20,55.0,9,15,5,10,19,45,11,0
Sébastien Corchia,fr FRA,DF,Nantes,fr Ligue 1,30,1990,15,33,20,17,11,5,24,42,57.1,18,24,3,21,13,46,36,0
Sergio Córdova,ve VEN,FWMF,Augsburg,de Bundesliga,23,1997,4,4,3,2,2,0,1,2,50.0,1,4,0,4,0,4,4,0
Jack Cork,eng ENG,MF,Burnley,eng Premier League,32,1989,19,20,6,6,11,3,7,20,35.0,13,17,4,13,17,37,29,1
Maxwel Cornet,ci CIV,FWMF,Burnley,eng Premier League,24,1996,20,16,9,7,5,4,7,15,46.7,8,13,4,9,10,26,14,0
Maxwel Cornet,ci CIV,DF,Lyon,fr Ligue 1,24,1996,1,3,1,1,0,2,3,4,75.0,1,0,0,0,1,4,1,0
Jesús Corona,mx MEX,FWDF,Sevilla,es La Liga,28,1993,13,12,7,7,5,0,3,6,50.0,3,4,0,4,8,20,6,0
Ángel Correa,ar ARG,FWMF,Atlético Madrid,es La Liga,26,1995,21,16,8,5,10,1,7,29,24.1,22,25,2,23,10,26,4,0
Joaquín Correa,ar ARG,FW,Inter,it Serie A,26,1994,11,11,5,2,6,3,1,13,7.7,12,8,1,7,3,14,2,0
Thierry Correia,pt POR,DF,Valencia,es La Liga,22,1999,16,35,23,26,6,3,14,29,48.3,15,20,5,15,19,54,27,0
Danny da Costa,de GER,DFMF,Eint Frankfurt,de Bundesliga,28,1993,8,15,4,6,7,2,6,18,33.3,12,14,1,13,11,26,18,1
David Pereira da Costa,pt POR,MFFW,Lens,fr Ligue 1,20,2001,16,22,12,9,6,7,11,26,42.3,15,12,0,12,13,35,5,0
Hélder Costa,ao ANG,MF,Leeds United,eng Premier League,27,1994,0,0,0,0,0,0,0,0,,0,1,0,1,0,0,0,0
Hélder Costa,ao ANG,MFFW,Valencia,es La Liga,27,1994,12,27,16,11,9,7,14,41,34.1,27,12,1,11,3,30,9,0
Jaume Costa,es ESP,DF,Mallorca,es La Liga,33,1988,20,35,26,23,7,5,23,31,74.2,8,22,7,15,23,58,55,0
Benoît Costil,fr FRA,GK,Bordeaux,fr Ligue 1,34,1987,25,1,0,1,0,0,1,2,50.0,1,0,0,0,0,1,6,3
Vladimír Coufal,cz CZE,DF,West Ham,eng Premier League,28,1992,25,45,25,24,14,7,18,36,50.0,18,31,9,22,22,67,64,1
Kalifa Coulibaly,ml MLI,FW,Nantes,fr Ligue 1,29,1991,9,5,1,1,1,3,0,4,0.0,4,2,2,0,0,5,11,0
Lassana Coulibaly,ml MLI,MF,Salernitana,it Serie A,25,1996,26,58,32,29,26,3,24,62,38.7,38,40,13,27,22,80,27,0
Mamadou Coulibaly,sn SEN,MF,Salernitana,it Serie A,22,1999,9,15,12,8,5,2,7,20,35.0,13,9,0,9,11,26,9,0
Tanguy Coulibaly,fr FRA,FWMF,Stuttgart,de Bundesliga,20,2001,12,27,15,14,11,2,9,19,47.4,10,14,2,12,4,31,10,0
Thibaut Courtois,be BEL,GK,Real Madrid,es La Liga,29,1992,36,1,0,1,0,0,1,2,50.0,1,0,0,0,0,1,9,1
Philippe Coutinho,br BRA,MFFW,Aston Villa,eng Premier League,29,1992,15,17,12,4,11,2,6,21,28.6,15,11,1,10,7,24,4,0
Philippe Coutinho,br BRA,MFFW,Barcelona,es La Liga,29,1992,6,6,3,3,3,0,3,11,27.3,8,3,0,3,4,10,3,0
Nicolas Cozza,fr FRA,DF,Montpellier,fr Ligue 1,22,1999,31,80,47,50,23,7,35,65,53.8,30,35,19,16,38,118,82,1
Alessio Cragno,it ITA,GK,Cagliari,it Serie A,27,1994,35,3,3,2,1,0,3,3,100.0,0,0,0,0,1,4,14,1
Aaron Cresswell,eng ENG,DF,West Ham,eng Premier League,31,1989,30,28,18,18,6,4,13,25,52.0,12,31,18,13,35,63,66,0
Charlie Cresswell,eng ENG,DF,Leeds United,eng Premier League,18,2002,2,5,2,1,4,0,3,3,100.0,0,1,1,0,2,7,6,0
Domenico Criscito,it ITA,DF,Genoa,it Serie A,34,1986,18,37,21,19,14,4,16,25,64.0,9,22,12,10,39,76,57,0
Bryan Cristante,it ITA,MF,Roma,it Serie A,26,1995,30,79,39,31,39,9,37,69,53.6,32,31,5,26,40,119,45,0
Cristo,es ESP,DF,Real Sociedad,es La Liga,21,2000,0,0,0,0,0,0,0,0,,0,0,0,0,0,0,0,0
Enzo Crivelli,fr FRA,FWMF,Saint-Étienne,fr Ligue 1,26,1995,1,1,0,0,0,1,0,0,,0,0,0,0,0,1,1,0
Domen Črnigoj,si SVN,MF,Venezia,it Serie A,25,1995,21,21,13,7,11,3,11,29,37.9,18,27,8,19,24,45,42,0
Giovanni Crociata,it ITA,FW,Empoli,it Serie A,23,1997,0,0,0,0,0,0,0,1,0.0,1,0,0,0,0,0,0,0
Juan Cruz Armada,es ESP,DF,Osasuna,es La Liga,29,1992,22,28,21,15,12,1,8,16,50.0,8,15,12,3,16,44,58,1
Juan Cuadrado,co COL,DFMF,Juventus,it Serie A,33,1988,28,48,23,30,13,5,30,55,54.5,25,23,5,18,29,77,34,0
Cucho,co COL,FWMF,Watford,eng Premier League,22,1999,13,13,5,5,5,3,5,27,18.5,22,13,1,12,5,18,9,0
Marc Cucurella,es ESP,DF,Brighton,eng Premier League,23,1998,34,93,62,43,32,18,44,71,62.0,27,42,14,28,30,123,74,0
Marc Cucurella,es ESP,MFDF,Getafe,es La Liga,23,1998,0,0,0,0,0,0,0,0,,0,0,0,0,0,0,0,0
Jorge Cuenca,es ESP,DF,Getafe,es La Liga,21,1999,30,46,32,30,15,1,21,28,75.0,7,29,14,15,39,85,155,0
Mickaël Cuisance,fr FRA,MF,Venezia,it Serie A,21,1999,10,23,9,7,12,4,10,28,35.7,18,14,0,14,12,35,5,0
Mickaël Cuisance,fr FRA,MF,Bayern Munich,de Bundesliga,21,1999,0,1,1,0,1,0,0,0,,0,0,0,0,0,1,0,0
Luke Cundle,eng ENG,MF,Wolves,eng Premier League,19,2002,2,4,3,0,4,0,1,1,100.0,0,0,0,0,1,5,1,0
Matheus Cunha,br BRA,FW,Atlético Madrid,es La Liga,22,1999,12,19,12,3,11,5,5,20,25.0,15,18,2,16,6,25,9,0
Matheus Cunha,br BRA,FW,Hertha BSC,de Bundesliga,22,1999,1,0,0,0,0,0,0,0,,0,0,0,0,0,0,0,0
Patrick Cutrone,it ITA,FW,Empoli,it Serie A,23,1998,16,5,2,0,3,2,1,9,11.1,8,11,1,10,5,10,1,0
Wylan Cyprien,fr FRA,MF,Nantes,fr Ligue 1,26,1995,17,33,17,12,18,3,13,32,40.6,19,16,6,10,10,43,14,2
Rafael Czichos,de GER,DF,Köln,de Bundesliga,31,1990,16,29,18,18,9,2,14,28,50.0,14,23,13,10,19,48,53,2
Lennart-Marten Czyborra,de GER,DF,Arminia,de Bundesliga,22,1999,2,0,0,0,0,0,0,2,0.0,2,0,0,0,3,3,3,1
Danilo D'Ambrosio,it ITA,DF,Inter,it Serie A,32,1988,11,30,15,21,8,1,11,22,50.0,11,21,10,11,8,38,20,0
Lucas Da Cunha,fr FRA,MF,Nice,fr Ligue 1,20,2001,4,13,7,2,7,4,6,11,54.5,5,2,0,2,1,14,2,0
Lucas Da Cunha,fr FRA,FWMF,Clermont Foot,fr Ligue 1,20,2001,9,17,11,5,8,4,9,18,50.0,9,13,0,13,1,18,3,0
Damien Da Silva,fr FRA,DF,Lyon,fr Ligue 1,33,1988,13,13,9,7,5,1,5,9,55.6,4,15,10,5,22,35,53,1
Moanes Dabbur,il ISR,FWMF,Hoffenheim,de Bundesliga,29,1992,15,17,9,3,5,9,4,17,23.5,13,10,0,10,5,22,4,0
Colin Dagba,fr FRA,DF,Paris S-G,fr Ligue 1,22,1998,2,4,2,2,2,0,3,6,50.0,3,4,2,2,2,6,1,0
Finn Dahmen,de GER,GK,Mainz 05,de Bundesliga,23,1998,2,0,0,0,0,0,0,0,,0,0,0,0,0,0,2,0
Mahmoud Dahoud,de GER,MF,Dortmund,de Bundesliga,25,1996,18,42,19,10,24,8,20,46,43.5,26,18,3,15,17,59,16,0
Patson Daka,zm ZAM,FW,Leicester City,eng Premier League,22,1998,13,15,10,2,8,5,2,19,10.5,17,7,0,7,2,17,8,0
Stuart Dallas,nir NIR,DFMF,Leeds United,eng Premier League,30,1991,32,93,55,58,31,4,56,105,53.3,49,45,14,31,57,150,63,2
Diogo Dalot,pt POR,DF,Manchester Utd,eng Premier League,22,1999,20,55,41,35,12,8,31,57,54.4,26,24,13,11,29,84,59,0
Mikkel Damsgaard,dk DEN,MFFW,Sampdoria,it Serie A,21,2000,6,27,13,12,11,4,20,36,55.6,16,16,1,15,7,34,7,0
Flavius Daniliuc,at AUT,DF,Nice,fr Ligue 1,20,2001,14,46,31,26,17,3,34,43,79.1,9,13,7,6,14,60,34,1
Danilo,br BRA,DFMF,Juventus,it Serie A,30,1991,21,37,26,20,13,4,18,28,64.3,10,21,12,9,32,69,53,1
Kevin Danso,at AUT,DF,Lens,fr Ligue 1,22,1998,31,41,29,29,12,0,23,34,67.6,11,38,25,13,40,81,111,0
Dante,br BRA,DF,Nice,fr Ligue 1,37,1983,32,42,29,30,12,0,23,33,69.7,10,43,27,16,49,91,96,1
Ebrima Darboe,gm GAM,MF,Roma,it Serie A,20,2001,1,1,1,0,1,0,0,0,,0,0,0,0,1,2,0,1
Márton Dárdai,de GER,DF,Hertha BSC,de Bundesliga,19,2002,8,10,4,8,2,0,8,18,44.4,10,16,6,10,20,30,33,2
Sergi Darder,es ESP,MF,Espanyol,es La Liga,27,1993,35,45,22,16,19,10,18,54,33.3,36,16,1,15,26,71,32,1
Vladimír Darida,cz CZE,MF,Hertha BSC,de Bundesliga,30,1990,20,32,18,15,13,4,13,32,40.6,19,22,3,19,20,52,17,2
Karl Darlow,eng ENG,GK,Newcastle Utd,eng Premier League,30,1990,8,0,0,0,0,0,0,0,,0,0,0,0,0,0,5,1
Matteo Darmian,it ITA,DF,Inter,it Serie A,31,1989,17,32,16,17,9,6,16,41,39.0,25,16,1,15,19,51,25,0
Josh Dasilva,eng ENG,MFFW,Brentford,eng Premier League,22,1998,3,2,1,0,1,1,1,2,50.0,1,3,0,3,1,3,7,0
Jonathan David,ca CAN,FW,Lille,fr Ligue 1,21,2000,31,24,9,7,11,6,9,30,30.0,21,14,4,10,5,29,15,0
Alphonso Davies,ca CAN,DF,Bayern Munich,de Bundesliga,20,2000,19,34,17,17,8,9,13,31,41.9,18,27,1,26,23,57,26,1
Ben Davies,wls WAL,DF,Tottenham,eng Premier League,28,1993,28,36,21,20,12,4,13,26,50.0,13,32,19,13,30,66,75,1
Tom Davies,eng ENG,MF,Everton,eng Premier League,23,1998,3,3,1,1,1,1,2,5,40.0,3,2,1,1,2,5,9,0
Keinan Davis,eng ENG,FW,Aston Villa,eng Premier League,23,1998,0,0,0,0,0,0,0,0,,0,0,0,0,0,0,0,0
Paweł Dawidowicz,pl POL,DF,Hellas Verona,it Serie A,26,1995,13,30,18,16,10,4,16,25,64.0,9,14,11,3,21,51,53,0
Craig Dawson,eng ENG,DF,West Ham,eng Premier League,31,1990,31,29,17,20,8,1,14,25,56.0,11,59,52,7,29,58,139,0
Kevin De Bruyne,be BEL,MF,Manchester City,eng Premier League,30,1991,25,32,16,4,15,13,12,37,32.4,25,32,2,30,6,38,16,0
Konrad De La Fuente,us USA,FWMF,Marseille,fr Ligue 1,20,2001,9,11,7,8,2,1,7,11,63.6,4,5,0,5,2,13,4,0
Sebastien De Maio,fr FRA,DF,Udinese,it Serie A,34,1987,2,5,1,4,1,0,1,9,11.1,8,6,5,1,1,6,9,0
Tommaso De Nipoti,it ITA,FW,Atalanta,it Serie A,18,2003,0,0,0,0,0,0,0,0,,0,0,0,0,0,0,0,0
Rodrigo De Paul,ar ARG,MF,Atlético Madrid,es La Liga,27,1994,24,55,30,22,25,8,30,60,50.0,30,24,3,21,21,76,17,2
Mattia De Sciglio,it ITA,DF,Juventus,it Serie A,28,1992,13,24,12,7,9,8,11,24,45.8,13,10,0,10,10,34,30,0
Lorenzo De Silvestri,it ITA,DF,Bologna,it Serie A,33,1988,26,23,14,13,8,2,9,31,29.0,22,25,7,18,26,49,52,0
Saulo Decarli,ch SUI,DF,Bochum,de Bundesliga,29,1992,0,0,0,0,0,0,0,0,,0,0,0,0,0,0,0,0
Troy Deeney,eng ENG,FW,Watford,eng Premier League,33,1988,0,0,0,0,0,0,0,1,0.0,1,0,0,0,0,0,2,0
Grégoire Defrel,mq MTQ,FW,Sassuolo,it Serie A,30,1991,15,15,9,4,8,3,6,16,37.5,10,11,1,10,4,19,11,0
Alessandro Deiola,it ITA,MF,Cagliari,it Serie A,25,1995,24,47,22,15,25,7,23,58,39.7,35,28,10,18,26,73,45,0
Romain Del Castillo,fr FRA,MFFW,Rennes,fr Ligue 1,25,1996,0,2,1,0,1,1,2,2,100.0,0,0,0,0,1,3,0,0
Romain Del Castillo,fr FRA,MFFW,Brest,fr Ligue 1,25,1996,11,27,16,3,17,7,12,31,38.7,19,12,0,12,7,34,3,0
Thomas Delaine,fr FRA,DF,Metz,fr Ligue 1,29,1992,26,48,35,34,12,2,22,42,52.4,20,20,7,13,27,75,31,0
Thomas Delaney,dk DEN,MF,Sevilla,es La Liga,29,1991,17,41,24,17,21,3,16,30,53.3,14,19,10,9,13,54,35,0
Thomas Delaney,dk DEN,MF,Dortmund,de Bundesliga,29,1991,0,0,0,0,0,0,0,0,,0,0,0,0,0,0,0,0
Liam Delap,eng ENG,FW,Manchester City,eng Premier League,18,2003,0,0,0,0,0,0,0,0,,0,0,0,0,0,0,0,0
Sacha Delaye,fr FRA,MFFW,Montpellier,fr Ligue 1,19,2002,3,8,6,3,2,3,2,8,25.0,6,1,0,1,1,9,1,1
Filippo Delli Carri,it ITA,DF,Salernitana,it Serie A,22,1999,4,6,4,4,2,0,5,14,35.7,9,6,2,4,4,10,14,0
Andy Delort,dz ALG,FW,Nice,fr Ligue 1,29,1991,27,15,9,3,5,7,7,12,58.3,5,13,4,9,9,24,14,0
Andy Delort,dz ALG,FW,Montpellier,fr Ligue 1,29,1991,3,2,0,0,1,1,0,1,0.0,1,1,0,1,0,2,4,0
Fabian Delph,eng ENG,MF,Everton,eng Premier League,31,1989,7,18,15,10,7,1,8,21,38.1,13,12,5,7,14,32,10,0
Moussa Dembélé,fr FRA,FW,Lyon,fr Ligue 1,25,1996,25,18,9,5,5,8,6,15,40.0,9,13,0,13,8,26,30,1
Ousmane Dembélé,fr FRA,FW,Barcelona,es La Liga,24,1997,16,24,16,6,10,8,7,23,30.4,16,8,0,8,8,32,3,0
Yusuf Demir,at AUT,FW,Barcelona,es La Liga,18,2003,2,3,1,1,1,1,2,5,40.0,3,1,0,1,2,5,1,0
Merih Demiral,tr TUR,DF,Atalanta,it Serie A,23,1998,21,31,17,18,12,1,15,28,53.6,13,26,14,12,58,89,68,1
Kerem Demirbay,de GER,MF,Leverkusen,de Bundesliga,28,1993,23,52,31,19,30,3,16,41,39.0,25,32,9,23,33,85,21,0
Ermedin Demirović,ba BIH,FW,Freiburg,de Bundesliga,23,1998,10,12,6,4,4,4,1,10,10.0,9,14,1,13,1,13,7,0
Diego Demme,de GER,MF,Napoli,it Serie A,29,1991,8,21,12,4,13,4,10,21,47.6,11,11,2,9,9,30,2,0
Jason Denayer,be BEL,DF,Lyon,fr Ligue 1,26,1995,11,11,4,8,3,0,6,7,85.7,1,8,7,1,16,27,52,0
Leander Dendoncker,be BEL,MF,Wolves,eng Premier League,26,1995,22,42,17,25,14,3,22,50,44.0,28,37,10,27,9,51,38,1
Emmanuel Dennis,ng NGA,FWMF,Watford,eng Premier League,23,1997,29,51,35,20,22,9,17,52,32.7,35,36,2,34,15,66,13,0
Fabio Depaoli,it ITA,DF,Hellas Verona,it Serie A,24,1997,8,12,7,6,4,2,1,7,14.3,6,9,2,7,8,20,14,0
Fabio Depaoli,it ITA,MFDF,Sampdoria,it Serie A,24,1997,1,3,1,1,2,0,0,2,0.0,2,2,1,1,1,4,2,0
Mike van der Hoorn,nl NED,DF,Arminia,de Bundesliga,28,1992,0,1,0,1,0,0,0,0,,0,0,0,0,1,2,2,0
Arthur Desmas,fr FRA,GK,Clermont Foot,fr Ligue 1,27,1994,15,0,0,0,0,0,0,3,0.0,3,0,0,0,0,0,1,3
Sergiño Dest,us USA,DFFW,Barcelona,es La Liga,20,2000,17,32,15,21,10,1,13,18,72.2,5,22,4,18,2,34,18,0
Mattia Destro,it ITA,FW,Genoa,it Serie A,30,1991,19,9,4,1,4,4,1,6,16.7,5,14,1,13,2,11,16,0
Gerard Deulofeu,es ESP,FWMF,Udinese,it Serie A,27,1994,29,11,6,2,3,6,7,29,24.1,22,14,0,14,9,20,4,0
Kiernan Dewsbury-Hall,eng ENG,MF,Leicester City,eng Premier League,22,1998,23,39,24,20,14,5,19,40,47.5,21,37,8,29,21,60,26,1
Jacopo Dezi,it ITA,MF,Venezia,it Serie A,29,1992,0,0,0,0,0,0,0,1,0.0,1,0,0,0,1,1,0,0
Samuel Di Carmine,it ITA,FW,Hellas Verona,it Serie A,32,1988,0,0,0,0,0,0,0,0,,0,0,0,0,0,0,0,0
Federico Di Francesco,it ITA,FWMF,Empoli,it Serie A,27,1994,15,16,5,2,8,6,9,23,39.1,14,17,1,16,9,25,11,0
Giovanni Di Lorenzo,it ITA,DF,Napoli,it Serie A,27,1993,32,58,36,30,20,8,33,58,56.9,25,28,10,18,38,96,46,1
Ángel Di María,ar ARG,FW,Paris S-G,fr Ligue 1,33,1988,18,29,18,6,13,10,14,37,37.8,23,17,0,17,6,35,3,0
Francesco Di Mariano,it ITA,FW,Venezia,it Serie A,25,1996,1,1,1,0,1,0,0,0,,0,2,1,1,0,1,0,0
Francesco Di Tacchio,it ITA,MF,Salernitana,it Serie A,31,1990,14,17,7,5,10,2,9,25,36.0,16,16,8,8,22,39,25,0
Boulaye Dia,sn SEN,FW,Villarreal,es La Liga,24,1996,14,8,6,3,4,1,2,5,40.0,3,6,1,5,5,13,4,0
Moussa Diaby,fr FRA,FWMF,Leverkusen,de Bundesliga,22,1999,31,20,11,8,9,3,5,38,13.2,33,11,0,11,8,28,2,0
Yadaly Diaby,fr FRA,FWMF,Clermont Foot,fr Ligue 1,20,2000,1,0,0,0,0,0,0,1,0.0,1,0,0,0,2,2,2,0
Mouctar Diakhaby,gn GUI,DF,Valencia,es La Liga,24,1996,22,35,24,18,15,2,13,23,56.5,10,29,17,12,30,65,87,3
Ibrahim Diakité,gn GUI,MF,Reims,fr Ligue 1,17,2003,0,0,0,0,0,0,0,1,0.0,1,0,0,0,0,0,0,0
Abdou Diallo,sn SEN,DF,Paris S-G,fr Ligue 1,25,1996,10,22,14,10,9,3,8,14,57.1,6,6,2,4,10,32,19,1
Habib Diallo,sn SEN,FW,Strasbourg,fr Ligue 1,26,1995,17,9,5,0,8,1,0,8,0.0,8,13,4,9,4,13,11,0
Ibrahima Diallo,fr FRA,MF,Southampton,eng Premier League,22,1999,11,22,11,10,9,3,10,24,41.7,14,7,0,7,9,31,10,0
Mouhamadou Diarra,sn SEN,MF,Strasbourg,fr Ligue 1,17,2004,1,2,1,1,1,0,1,1,100.0,0,0,0,0,0,2,0,0
Stéphane Diarra,fr FRA,MFFW,Lorient,fr Ligue 1,22,1998,6,11,9,7,3,1,5,10,50.0,5,4,0,4,7,18,1,0
Rúben Dias,pt POR,DF,Manchester City,eng Premier League,24,1997,27,26,19,11,12,3,8,15,53.3,7,19,13,6,23,49,66,0
Krépin Diatta,sn SEN,MFDF,Monaco,fr Ligue 1,22,1999,3,3,2,1,0,2,1,3,33.3,2,2,0,2,1,4,0,0
Amadou Diawara,gn GUI,MF,Roma,it Serie A,24,1997,2,7,2,5,2,0,1,3,33.3,2,2,0,2,0,7,1,0
Brahim Díaz,es ESP,MF,Milan,it Serie A,21,1999,21,23,17,3,11,9,8,22,36.4,14,11,0,11,8,31,4,0
Javier Díaz,es ESP,GK,Sevilla,es La Liga,24,1997,1,0,0,0,0,0,0,0,,0,0,0,0,0,0,0,0
Luis Díaz,co COL,FW,Liverpool,eng Premier League,24,1997,11,9,7,3,5,1,2,8,25.0,6,7,0,7,4,13,2,0
Víctor Díaz,es ESP,DF,Granada,es La Liga,33,1988,17,23,15,14,9,0,12,25,48.0,13,19,11,8,17,40,71,1
Daniel Didavi,de GER,MFFW,Stuttgart,de Bundesliga,31,1990,3,6,2,0,4,2,4,7,57.1,3,4,1,3,1,7,1,0
Bamba Dieng,sn SEN,FW,Marseille,fr Ligue 1,21,2000,11,17,11,5,5,7,4,14,28.6,10,7,0,7,5,22,8,0
Eric Dier,eng ENG,DF,Tottenham,eng Premier League,27,1994,34,15,9,6,8,1,7,14,50.0,7,37,32,5,27,42,142,1
Elhadji Dieye,sn SEN,FWMF,Saint-Étienne,fr Ligue 1,19,2002,0,3,2,2,1,0,0,1,0.0,1,2,0,2,1,4,0,0
Lucas Digne,fr FRA,DF,Aston Villa,eng Premier League,28,1993,14,13,10,8,3,2,9,19,47.4,10,15,8,7,23,36,40,0
Lucas Digne,fr FRA,DF,Everton,eng Premier League,28,1993,13,33,19,26,4,3,21,28,75.0,7,16,5,11,14,47,30,0
Mitchell Dijks,nl NED,DFFW,Bologna,it Serie A,28,1993,8,15,6,6,6,3,5,12,41.7,7,11,2,9,3,18,10,1
Javairô Dilrosun,nl NED,MFFW,Bordeaux,fr Ligue 1,23,1998,19,13,4,2,8,3,7,24,29.2,17,14,1,13,11,24,5,0
Javairô Dilrosun,nl NED,FW,Hertha BSC,de Bundesliga,23,1998,2,3,1,1,2,0,1,1,100.0,0,1,0,1,0,3,0,0
Federico Dimarco,it ITA,DF,Inter,it Serie A,23,1997,16,28,15,10,15,3,13,24,54.2,11,6,1,5,19,47,19,0
Landry Dimata,be BEL,FWMF,Espanyol,es La Liga,23,1997,6,2,2,1,1,0,1,4,25.0,3,0,0,0,1,3,7,0
Stole Dimitrievski,mk MKD,GK,Rayo Vallecano,es La Liga,27,1993,31,0,0,0,0,0,0,0,,0,0,0,0,1,1,14,3
Junior Dina Ebimbe,fr FRA,MF,Paris S-G,fr Ligue 1,20,2000,4,9,4,3,4,2,2,3,66.7,1,5,3,2,2,11,1,0
Tristan Dingomé,cm CMR,MFFW,Troyes,fr Ligue 1,30,1991,12,23,11,10,12,1,10,18,55.6,8,7,1,6,9,32,3,0
Sinaly Diomande,ci CIV,DF,Lyon,fr Ligue 1,20,2001,6,6,3,4,2,0,5,6,83.3,1,6,6,0,12,18,26,0
Issa Diop,fr FRA,DF,West Ham,eng Premier League,24,1997,11,10,8,5,5,0,4,11,36.4,7,14,13,1,7,17,44,0
Sofiane Diop,fr FRA,MFFW,Monaco,fr Ligue 1,21,2000,22,38,20,12,19,7,15,47,31.9,32,10,0,10,23,61,4,0
Andy Diouf,fr FRA,MF,Rennes,fr Ligue 1,18,2003,0,1,1,1,0,0,1,1,100.0,0,1,0,1,0,1,0,0
Assane Dioussé,sn SEN,MF,Saint-Étienne,fr Ligue 1,23,1997,0,1,1,1,0,0,1,1,100.0,0,0,0,0,0,1,0,0
Axel Disasi,fr FRA,DF,Monaco,fr Ligue 1,23,1998,30,42,27,20,21,1,23,39,59.0,16,40,30,10,26,68,75,0
Filippo Distefano,it ITA,FW,Fiorentina,it Serie A,17,2003,0,0,0,0,0,0,0,0,,0,0,0,0,0,0,0,0
Matías Dituro,ar ARG,GK,Celta Vigo,es La Liga,34,1987,38,0,0,0,0,0,0,0,,0,0,0,0,0,0,10,5
Tiago Djaló,pt POR,DF,Lille,fr Ligue 1,21,2000,26,60,39,39,19,2,26,39,66.7,13,26,10,16,24,84,71,0
Djené,tg TOG,DF,Getafe,es La Liga,29,1991,35,44,26,24,16,4,23,34,67.6,11,24,5,19,59,103,109,2
Moussa Djenepo,ml MLI,MF,Southampton,eng Premier League,23,1998,5,9,3,3,5,1,3,11,27.3,8,6,1,5,2,11,6,1
Koffi Djidji,ci CIV,DF,Torino,it Serie A,28,1992,19,48,29,21,23,4,14,18,77.8,4,20,9,11,34,82,60,0
Alexander Djiku,gh GHA,DF,Strasbourg,fr Ligue 1,26,1994,30,50,37,33,13,4,18,35,51.4,17,30,13,17,61,111,90,2
Bryan Djile Nokoué,cm CMR,DFMF,Saint-Étienne,fr Ligue 1,19,2002,1,3,3,1,2,0,2,2,100.0,0,1,0,1,1,4,2,0
Berat Djimsiti,al ALB,DF,Atalanta,it Serie A,28,1993,25,43,24,21,20,2,29,46,63.0,17,21,11,10,31,74,56,0
Ouparine Djoco,sn SEN,GK,Clermont Foot,fr Ligue 1,23,1998,24,0,0,0,0,0,0,0,,0,0,0,0,1,1,14,2
Naïs Djouahra,fr FRA,FWMF,Real Sociedad,es La Liga,21,1999,2,7,3,2,2,3,4,8,50.0,4,3,0,3,2,9,2,0
Marko Dmitrović,rs SRB,GK,Sevilla,es La Liga,29,1992,6,0,0,0,0,0,0,0,,0,0,0,0,0,0,3,1
Lewis Dobbin,eng ENG,FWMF,Everton,eng Premier League,18,2003,0,2,1,0,1,1,1,2,50.0,1,0,0,0,0,2,0,0
Matt Doherty,ie IRL,DF,Tottenham,eng Premier League,29,1992,10,18,12,5,11,2,8,14,57.1,6,11,2,9,13,31,20,0
Jeremy Doku,be BEL,FWMF,Rennes,fr Ligue 1,19,2002,5,10,5,3,5,2,3,6,50.0,3,4,0,4,3,13,0,0
Kasper Dolberg,dk DEN,FW,Nice,fr Ligue 1,23,1997,17,9,4,4,3,2,3,9,33.3,6,15,1,14,6,15,17,0
Jaume Doménech,es ESP,GK,Valencia,es La Liga,30,1990,4,0,0,0,0,0,0,0,,0,0,0,0,0,0,3,1
Brandon Domingues,fr FRA,MFFW,Troyes,fr Ligue 1,21,2000,3,6,2,2,4,0,2,3,66.7,1,3,0,3,3,9,0,0
Carlos Dominguez,es ESP,DF,Celta Vigo,es La Liga,20,2001,4,4,1,4,0,0,4,6,66.7,2,2,1,1,4,8,21,0
Mario Dominguez,es ESP,FW,Valencia,es La Liga,17,2004,0,0,0,0,0,0,0,0,,0,0,0,0,0,0,1,0
Nicolás Domínguez,ar ARG,MF,Bologna,it Serie A,23,1998,22,76,45,36,32,8,32,76,42.1,44,38,9,29,32,108,34,1
John Donald,es ESP,DF,Elche,es La Liga,20,2000,2,7,4,4,2,1,5,8,62.5,3,5,3,2,3,10,3,0
Lee Dongjun,kr KOR,MFFW,Hertha BSC,de Bundesliga,24,1997,1,2,1,0,2,0,1,3,33.3,2,2,0,2,2,4,1,0
Anastasios Donis,gr GRE,FWMF,Reims,fr Ligue 1,24,1996,4,8,7,4,2,2,2,6,33.3,4,3,0,3,0,8,1,0
Gianluigi Donnarumma,it ITA,GK,Paris S-G,fr Ligue 1,22,1999,17,0,0,0,0,0,0,0,,0,0,0,0,0,0,9,2
Niklas Dorsch,de GER,MF,Augsburg,de Bundesliga,23,1998,26,76,47,47,23,6,30,60,50.0,30,34,12,22,35,111,36,3
Gabriel Dos Santos,br BRA,DF,Arsenal,eng Premier League,23,1997,34,50,30,36,12,2,30,41,73.2,11,34,26,8,13,63,112,4
Jodel Dossou,bj BEN,FW,Clermont Foot,fr Ligue 1,29,1992,22,36,17,15,14,7,15,43,34.9,28,14,0,14,5,41,7,0
Lohann Doucet,fr FRA,MFDF,Nantes,fr Ligue 1,18,2002,0,0,0,0,0,0,0,0,,0,0,0,0,1,1,0,0
Abdoulaye Doucouré,ml MLI,MF,Everton,eng Premier League,28,1993,28,75,43,30,37,8,32,71,45.1,39,33,8,25,28,103,32,0
Cheick Doucouré,ml MLI,MF,Lens,fr Ligue 1,21,2000,33,75,43,34,34,7,36,80,45.0,44,30,7,23,68,143,24,0
Fodé Doucouré,ml MLI,DFFW,Reims,fr Ligue 1,20,2001,2,12,9,9,3,0,9,11,81.8,2,1,0,1,4,16,6,0
Ismaël Doukouré,fr FRA,DF,Strasbourg,fr Ligue 1,18,2003,0,0,0,0,0,0,0,0,,0,0,0,0,0,0,1,0
Kamory Doumbia,ml MLI,MFFW,Reims,fr Ligue 1,18,2003,4,8,2,2,5,1,5,13,38.5,8,9,3,6,3,11,3,0
Moussa Doumbia,ml MLI,FW,Reims,fr Ligue 1,26,1994,1,0,0,0,0,0,0,1,0.0,1,0,0,0,0,0,0,0
Souleyman Doumbia,ci CIV,DFFW,Angers,fr Ligue 1,24,1996,25,30,20,16,9,5,13,27,48.1,14,25,4,21,39,69,51,0
Kieran Dowell,eng ENG,FWMF,Norwich City,eng Premier League,23,1997,10,18,7,8,7,3,9,32,28.1,23,10,1,9,7,25,4,0
Bartłomiej Drągowski,pl POL,GK,Fiorentina,it Serie A,23,1997,6,0,0,0,0,0,0,0,,0,0,0,0,1,1,5,2
Radu Drăgușin,ro ROU,DF,Sampdoria,it Serie A,19,2002,7,4,3,2,2,0,2,6,33.3,4,8,4,4,10,14,33,0
Radu Drăgușin,ro ROU,DF,Salernitana,it Serie A,19,2002,5,5,4,2,3,0,4,10,40.0,6,7,3,4,13,18,17,0
Cody Drameh,eng ENG,DFMF,Leeds United,eng Premier League,19,2001,1,4,2,3,1,0,1,3,33.3,2,0,0,0,1,5,4,0
Julian Draxler,de GER,FWMF,Paris S-G,fr Ligue 1,27,1993,6,3,2,0,3,0,0,4,0.0,4,3,0,3,5,8,3,0
Matthieu Dreyer,fr FRA,GK,Lorient,fr Ligue 1,32,1989,16,1,1,1,0,0,1,1,100.0,0,0,0,0,0,1,9,0
Domingos Duarte,pt POR,DF,Granada,es La Liga,26,1995,19,18,14,9,9,0,6,11,54.5,5,27,20,7,22,40,82,0
Óscar Duarte,cr CRC,DF,Levante,es La Liga,32,1989,20,18,8,12,6,0,8,23,34.8,15,18,9,9,24,42,102,0
Rubén Duarte,es ESP,DF,Alavés,es La Liga,25,1995,29,76,47,43,27,6,43,85,50.6,42,40,6,34,57,133,82,0
Leo Dubois,fr FRA,DF,Lyon,fr Ligue 1,26,1994,19,43,27,22,14,7,27,46,58.7,19,27,3,24,22,65,35,1
Martin Dúbravka,sk SVK,GK,Newcastle Utd,eng Premier League,32,1989,26,1,1,1,0,0,0,1,0.0,1,0,0,0,0,1,8,2
Ondrej Duda,sk SVK,MFFW,Köln,de Bundesliga,26,1994,18,23,16,4,12,7,6,23,26.1,17,14,2,12,17,40,9,0
Jeremy Dudziak,tn TUN,MFFW,Greuther Fürth,de Bundesliga,25,1995,13,17,6,5,8,4,3,14,21.4,11,8,0,8,10,27,4,0
Shane Duffy,ie IRL,DF,Brighton,eng Premier League,29,1992,16,15,12,12,3,0,8,14,57.1,6,24,18,6,16,31,76,1
Unai Dufur,es ESP,DF,Osasuna,es La Liga,22,1999,1,0,0,0,0,0,0,0,,0,1,0,1,4,4,4,0
Denzel Dumfries,nl NED,DF,Inter,it Serie A,25,1996,23,32,12,9,14,9,16,32,50.0,16,15,6,9,9,41,26,0
Paul Dummett,wls WAL,DF,Newcastle Utd,eng Premier League,29,1991,2,7,3,3,4,0,5,8,62.5,3,5,0,5,3,10,5,0
Alfred Duncan,gh GHA,MF,Fiorentina,it Serie A,28,1993,22,34,19,13,16,5,11,32,34.4,21,32,3,29,10,44,7,0
Lewis Dunk,eng ENG,DF,Brighton,eng Premier League,29,1991,29,10,8,5,5,0,5,11,45.5,6,32,28,4,27,37,113,3
Erik Durm,de GER,DF,Eint Frankfurt,de Bundesliga,29,1992,5,13,7,6,5,2,10,13,76.9,3,8,1,7,10,23,7,0
Hugo Duro,es ESP,DFMF,Getafe,es La Liga,21,1999,0,0,0,0,0,0,0,0,,0,0,0,0,0,0,0,0
Hugo Duro,es ESP,FWMF,Valencia,es La Liga,21,1999,20,25,19,11,13,1,15,38,39.5,23,24,2,22,4,29,20,1
Jean-Kevin Duverne,fr FRA,DF,Brest,fr Ligue 1,24,1997,33,71,44,43,21,7,42,90,46.7,48,40,5,35,53,124,92,0
Paulo Dybala,ar ARG,FWMF,Juventus,it Serie A,27,1993,23,30,13,7,14,9,8,35,22.9,27,19,0,19,9,39,4,3
Edin Džeko,ba BIH,FW,Inter,it Serie A,35,1986,27,14,8,7,4,3,8,25,32.0,17,22,5,17,4,18,35,0
Enzo Ebosse,cm CMR,DF,Angers,fr Ligue 1,22,1999,21,25,14,19,6,0,11,19,57.9,8,19,9,10,15,40,42,0
Tyronne Ebuehi,ng NGA,DF,Venezia,it Serie A,25,1995,13,28,12,16,8,4,10,18,55.6,8,13,3,10,16,44,38,1
Ederson,br BRA,GK,Manchester City,eng Premier League,27,1993,37,2,1,2,0,0,0,2,0.0,2,0,0,0,0,2,12,0
Éderson,br BRA,MF,Salernitana,it Serie A,22,1999,13,29,18,11,14,4,14,26,53.8,12,11,2,9,19,48,8,0
Odsonne Édouard,fr FRA,FW,Crystal Palace,eng Premier League,23,1998,17,16,10,2,7,7,7,21,33.3,14,20,5,15,0,16,18,0
CJ Egan-Riley,eng ENG,DF,Manchester City,eng Premier League,18,2003,0,1,1,1,0,0,1,1,100.0,0,0,0,0,0,1,0,0
Maximilian Eggestein,de GER,MF,Freiburg,de Bundesliga,24,1996,24,48,28,17,25,6,22,50,44.0,28,35,11,24,30,78,32,1
Lilian Egloff,de GER,MFDF,Stuttgart,de Bundesliga,18,2002,0,1,0,0,1,0,0,0,,0,1,0,1,0,1,0,0
Kingsley Ehizibue,nl NED,DF,Köln,de Bundesliga,26,1995,8,32,18,27,5,0,15,24,62.5,9,13,4,9,9,41,26,0
Julian Eitschberger,de GER,DF,Hertha BSC,de Bundesliga,17,2004,1,0,0,0,0,0,0,1,0.0,1,1,1,0,2,2,2,0
Albin Ekdal,se SWE,MF,Sampdoria,it Serie A,32,1989,18,43,28,17,21,5,26,56,46.4,30,27,7,20,29,72,25,0
Hugo Ekitike,fr FRA,FW,Reims,fr Ligue 1,19,2002,14,18,10,8,6,4,4,11,36.4,7,9,2,7,6,24,15,0
Jurgen Ekkelenkamp,nl NED,MFFW,Hertha BSC,de Bundesliga,21,2000,8,8,3,2,6,0,2,7,28.6,5,9,2,7,4,12,5,0
Caleb Ekuban,gh GHA,FWMF,Genoa,it Serie A,27,1994,19,19,12,2,12,5,7,23,30.4,16,19,5,14,9,28,6,0
Anthony Elanga,se SWE,FW,Manchester Utd,eng Premier League,19,2002,14,26,20,12,12,2,15,29,51.7,14,17,1,16,9,35,7,0
Alberth Elis,hn HON,FWMF,Bordeaux,fr Ligue 1,25,1996,16,19,10,5,5,9,11,25,44.0,14,9,0,9,7,26,10,0
Harvey Elliott,eng ENG,MF,Liverpool,eng Premier League,18,2003,4,3,0,1,1,1,0,6,0.0,6,8,1,7,4,7,2,0
Elif Elmas,mk MKD,FWMF,Napoli,it Serie A,21,1999,18,25,15,10,10,5,12,28,42.9,16,13,2,11,8,33,17,0
Mohamed Elneny,eg EGY,MF,Arsenal,eng Premier League,29,1992,9,16,8,10,5,1,7,12,58.3,5,7,1,6,14,30,13,0
Aritz Elustondo,es ESP,DF,Real Sociedad,es La Liga,27,1994,23,21,14,16,5,0,10,20,50.0,10,19,13,6,29,50,86,0
Nico Elvedi,ch SUI,DF,M'Gladbach,de Bundesliga,24,1996,27,40,24,23,17,0,22,36,61.1,14,33,22,11,34,74,83,1
Sepe Elye Wahi,fr FRA,FW,Montpellier,fr Ligue 1,18,2003,20,18,10,9,6,3,6,16,37.5,10,7,0,7,4,22,4,0
Mohamed Elyounoussi,no NOR,MFFW,Southampton,eng Premier League,26,1994,23,36,17,14,15,7,11,39,28.2,28,23,2,21,12,48,28,0
Adri Embarba,es ESP,FWMF,Espanyol,es La Liga,29,1992,22,44,29,22,15,7,26,69,37.7,43,35,3,32,19,63,30,0
Breel Embolo,ch SUI,FWMF,M'Gladbach,de Bundesliga,24,1997,24,17,11,2,12,3,4,9,44.4,5,14,2,12,6,23,8,0
Emerson,br BRA,DFMF,Tottenham,eng Premier League,22,1999,25,72,47,50,16,6,36,67,53.7,31,25,2,23,22,94,92,1
Emerson,br BRA,DF,Barcelona,es La Liga,22,1999,1,3,3,2,1,0,1,2,50.0,1,1,0,1,2,5,1,0
Renaud Emond,be BEL,FWMF,Nantes,fr Ligue 1,29,1991,2,1,0,0,1,0,0,4,0.0,4,2,1,1,0,1,1,0
Youssef En-Nesyri,ma MAR,FW,Sevilla,es La Liga,24,1997,14,10,5,5,2,3,4,11,36.4,7,9,1,8,4,14,18,0
Keita Endo,jp JPN,MF,Union Berlin,de Bundesliga,23,1997,1,1,1,1,0,0,0,0,,0,1,0,1,0,1,0,0
Wataru Endo,jp JPN,MF,Stuttgart,de Bundesliga,28,1993,32,73,41,34,34,5,31,72,43.1,41,43,12,31,30,103,64,0
Christian Eriksen,dk DEN,MF,Brentford,eng Premier League,29,1992,10,13,6,4,5,4,8,17,47.1,9,9,1,8,9,22,14,0
Martin Erlic,hr CRO,DF,Spezia,it Serie A,23,1998,29,28,16,18,10,0,10,18,55.6,8,54,39,15,28,56,122,1
Gonzalo Escalante,ar ARG,MF,Lazio,it Serie A,28,1993,0,1,0,1,0,0,1,1,100.0,0,2,1,1,1,2,0,0
Gonzalo Escalante,ar ARG,MF,Alavés,es La Liga,28,1993,14,30,14,9,20,1,13,34,38.2,21,27,2,25,21,51,28,0
Aarón Escandell,es ESP,GK,Granada,es La Liga,25,1995,3,0,0,0,0,0,0,1,0.0,1,0,0,0,0,0,4,0
Sergio Escudero,es ESP,DFMF,Granada,es La Liga,31,1989,16,46,24,25,17,4,26,54,48.1,28,18,3,15,26,72,35,0
Alfonso Espino,uy URU,DF,Cádiz,es La Liga,29,1992,37,107,63,58,39,10,44,112,39.3,68,45,10,35,54,161,87,1
Michael Esser,de GER,GK,Bochum,de Bundesliga,33,1987,3,0,0,0,0,0,0,1,0.0,1,0,0,0,0,0,2,0
Estanis,es ESP,FW,Barcelona,es La Liga,17,2003,0,1,1,0,1,0,1,1,100.0,0,0,0,0,0,1,0,0
Maxime Estève,fr FRA,DF,Montpellier,fr Ligue 1,19,2002,21,27,18,22,4,1,15,27,55.6,12,31,24,7,22,49,69,1
Pervis Estupiñán,ec ECU,DF,Villarreal,es La Liga,23,1998,18,36,22,20,11,5,17,24,70.8,7,13,5,8,25,61,29,2
Oghenekaro Etebo,ng NGA,MF,Watford,eng Premier League,25,1995,5,11,8,7,4,0,3,8,37.5,5,3,1,2,5,16,5,0
Jonny Evans,nir NIR,DF,Leicester City,eng Premier League,33,1988,15,24,14,14,8,2,14,22,63.6,8,17,13,4,20,44,59,0
Eberechi Eze,eng ENG,MFFW,Crystal Palace,eng Premier League,23,1998,7,10,6,5,2,3,6,11,54.5,5,4,1,3,5,15,1,0
Abdessamad Ezzalzouli,ma MAR,FW,Barcelona,es La Liga,19,2001,6,17,9,9,5,3,5,8,62.5,3,3,0,3,9,26,0,0
Łukasz Fabiański,pl POL,GK,West Ham,eng Premier League,36,1985,37,0,0,0,0,0,0,0,,0,0,0,0,0,0,11,0
Fabinho,br BRA,MF,Liverpool,eng Premier League,27,1993,26,46,25,17,23,6,24,70,34.3,46,33,10,23,39,85,25,1
Fábio,br BRA,DF,Nantes,fr Ligue 1,31,1990,19,61,40,31,23,7,36,74,48.6,38,29,7,22,35,96,31,1
Cesc Fàbregas,es ESP,MF,Monaco,fr Ligue 1,34,1987,0,1,0,0,1,0,1,1,100.0,0,0,0,0,1,2,0,0
Wout Faes,be BEL,DF,Reims,fr Ligue 1,23,1998,37,40,24,30,9,1,25,33,75.8,8,47,37,10,53,93,169,2
Wahidullah Faghir,dk DEN,FW,Stuttgart,de Bundesliga,18,2003,1,0,0,0,0,0,0,1,0.0,1,2,0,2,0,0,0,0
Romain Faivre,fr FRA,FWMF,Lyon,fr Ligue 1,23,1998,10,10,4,2,6,2,4,13,30.8,9,4,0,4,3,13,2,0
Romain Faivre,fr FRA,MF,Brest,fr Ligue 1,23,1998,20,30,18,12,13,5,12,30,40.0,18,11,0,11,13,43,10,0
Radamel Falcao,co COL,FW,Rayo Vallecano,es La Liga,35,1986,9,2,1,0,1,1,1,4,25.0,3,4,1,3,2,4,11,0
Diego Falcinelli,it ITA,FW,Bologna,it Serie A,30,1991,1,2,2,2,0,0,0,0,,0,0,0,0,1,3,1,0
Wladimiro Falcone,it ITA,GK,Sampdoria,it Serie A,26,1995,10,0,0,0,0,0,0,0,,0,0,0,0,1,1,5,0
Fali,es ESP,DFMF,Cádiz,es La Liga,27,1993,20,32,19,24,8,0,17,32,53.1,15,26,16,10,24,56,82,0
Paolo Faragò,it ITA,MF,Cagliari,it Serie A,28,1993,0,1,1,1,0,0,0,0,,0,2,0,2,0,1,0,0
Omar Faraj,se SWE,FW,Levante,es La Liga,19,2002,0,1,0,1,0,0,1,1,100.0,0,0,0,0,0,1,0,0
Davide Faraoni,it ITA,DF,Hellas Verona,it Serie A,29,1991,29,62,40,38,21,3,29,62,46.8,33,38,5,33,23,85,62,1
Mohamed Fares,dz ALG,DFFW,Genoa,it Serie A,25,1996,7,4,2,1,3,0,0,4,0.0,4,8,3,5,8,12,11,0
Diego Farias,br BRA,MFFW,Cagliari,it Serie A,31,1990,1,1,1,0,1,0,1,3,33.3,2,0,0,0,0,1,0,0
Wuilker Faríñez,ve VEN,GK,Lens,fr Ligue 1,23,1998,12,0,0,0,0,0,0,0,,0,0,0,0,0,0,4,0
Ömer Faruk Beyaz,tr TUR,DFMF,Stuttgart,de Bundesliga,17,2003,1,4,3,1,3,0,1,5,20.0,4,0,0,0,2,6,0,0
Noah Fatar,fr FRA,DFMF,Angers,fr Ligue 1,19,2002,0,1,0,0,0,1,0,1,0.0,1,0,0,0,1,2,0,0
Ansu Fati,es ESP,FW,Barcelona,es La Liga,18,2002,4,3,2,0,2,1,1,1,100.0,0,4,0,4,1,4,0,0
Julien Faussurier,fr FRA,MFDF,Brest,fr Ligue 1,34,1987,5,10,6,3,3,4,6,13,46.2,7,12,1,11,5,15,6,0
Andrea Favilli,it ITA,FW,Genoa,it Serie A,24,1997,0,1,1,0,0,1,0,0,,0,0,0,0,0,1,2,0
Federico Fazio,ar ARG,DF,Salernitana,it Serie A,34,1987,16,17,11,10,6,1,9,12,75.0,3,21,16,5,27,44,67,1
Aleix Febas,es ESP,MF,Mallorca,es La Liga,25,1996,1,4,1,0,4,0,2,4,50.0,2,0,0,0,0,4,0,0
Adrian Fein,de GER,MF,Greuther Fürth,de Bundesliga,22,1999,0,0,0,0,0,0,0,1,0.0,1,0,0,0,2,2,0,0
Nabil Fekir,fr FRA,MF,Betis,es La Liga,28,1993,31,43,29,5,25,13,7,36,19.4,29,14,0,14,7,50,7,0
Felipe,br BRA,DF,Atlético Madrid,es La Liga,32,1989,17,20,15,11,8,1,8,18,44.4,10,17,11,6,28,48,77,0
Luiz Felipe,it ITA,DF,Lazio,it Serie A,24,1997,28,41,23,21,16,4,20,34,58.8,14,40,33,7,33,74,102,1
João Félix,pt POR,FWMF,Atlético Madrid,es La Liga,21,1999,14,5,2,1,4,0,1,5,20.0,4,4,1,3,7,12,8,0
Ohis Felix Uduokhai,de GER,DF,Augsburg,de Bundesliga,23,1997,9,9,6,6,3,0,6,11,54.5,5,13,8,5,9,18,33,0
Kiko Femenía,es ESP,DF,Watford,eng Premier League,30,1991,24,35,22,23,10,2,21,37,56.8,16,24,8,16,37,72,51,0
Evan Ferguson,ie IRL,MF,Brighton,eng Premier League,16,2004,0,0,0,0,0,0,0,0,,0,0,0,0,0,0,0,0
Nathan Ferguson,eng ENG,DF,Crystal Palace,eng Premier League,20,2000,0,0,0,0,0,0,0,0,,0,0,0,0,0,0,0,0
Bruno Fernandes,pt POR,MF,Manchester Utd,eng Premier League,26,1994,35,54,28,26,22,6,26,91,28.6,65,36,0,36,17,71,42,2
Edimilson Fernandes,ch SUI,MFFW,Arminia,de Bundesliga,25,1996,3,2,0,1,1,0,1,4,25.0,3,2,2,0,2,4,6,0
Aitor Fernández,es ESP,GK,Levante,es La Liga,30,1991,13,2,1,2,0,0,2,2,100.0,0,0,0,0,0,2,7,0
Álex Fernández,es ESP,MF,Cádiz,es La Liga,28,1992,23,47,31,22,17,8,21,61,34.4,40,30,7,23,30,77,31,0
Álvaro Fernández,es ESP,GK,Brentford,eng Premier League,23,1998,12,0,0,0,0,0,0,0,,0,0,0,0,0,0,5,2
Federico Fernández,ar ARG,DF,Newcastle Utd,eng Premier League,32,1989,6,3,0,3,0,0,2,5,40.0,3,10,10,0,4,7,28,0
Fernandinho,br BRA,MFDF,Manchester City,eng Premier League,36,1985,11,21,10,7,10,4,9,27,33.3,18,8,2,6,8,29,13,1
Fernando,br BRA,MFDF,Sevilla,es La Liga,34,1987,21,24,17,14,9,1,12,33,36.4,21,21,13,8,29,53,32,2
Alex Ferrari,it ITA,DF,Sampdoria,it Serie A,27,1994,18,40,22,28,9,3,19,33,57.6,14,31,22,9,39,79,63,1
Salvador Ferrer,es ESP,DFMF,Spezia,it Serie A,23,1998,17,32,18,15,9,8,12,25,48.0,13,24,12,12,18,50,46,0
Jordan Ferri,fr FRA,MF,Montpellier,fr Ligue 1,29,1992,32,55,35,28,23,4,29,87,33.3,58,21,5,16,30,85,35,0
Riccardo Fiamozzi,it ITA,DF,Empoli,it Serie A,28,1993,7,7,5,2,2,3,2,4,50.0,2,6,5,1,7,14,12,0
Fidel,es ESP,MF,Elche,es La Liga,31,1989,25,44,23,18,17,9,14,57,24.6,43,9,1,8,7,51,20,0
Karol Fila,pl POL,DF,Strasbourg,fr Ligue 1,23,1998,6,10,8,5,4,1,4,8,50.0,4,7,2,5,4,14,6,0
Alfreð Finnbogason,is ISL,FW,Augsburg,de Bundesliga,32,1989,3,3,1,0,2,1,2,4,50.0,2,5,1,4,2,5,8,0
Luca Fiordilino,it ITA,MF,Venezia,it Serie A,25,1996,7,21,13,11,6,4,13,27,48.1,14,14,4,10,11,32,12,0
Vincenzo Fiorillo,it ITA,GK,Salernitana,it Serie A,31,1990,1,0,0,0,0,0,0,0,,0,0,0,0,0,0,1,0
Roberto Firmino,br BRA,FW,Liverpool,eng Premier League,29,1991,11,23,14,5,8,10,3,16,18.8,13,20,0,20,4,27,3,0
Junior Firpo,es ESP,DFMF,Leeds United,eng Premier League,24,1996,19,60,28,29,26,5,31,59,52.5,28,22,6,16,24,84,38,0
Mark Flekken,nl NED,GK,Freiburg,de Bundesliga,28,1993,32,0,0,0,0,0,0,2,0.0,2,1,0,1,2,2,10,1
Ashley Fletcher,eng ENG,FW,Watford,eng Premier League,25,1995,0,2,1,1,1,0,1,1,100.0,0,1,1,0,0,2,0,0
Alexis Flips,fr FRA,MFDF,Reims,fr Ligue 1,21,2000,12,37,21,21,9,7,22,45,48.9,23,21,0,21,24,61,17,0
Alessandro Florenzi,it ITA,DFFW,Milan,it Serie A,30,1991,13,28,14,14,7,7,14,32,43.8,18,9,2,7,27,55,10,1
Phil Foden,eng ENG,FW,Manchester City,eng Premier League,21,2000,24,16,8,10,4,2,7,17,41.2,10,9,0,9,11,27,5,0
Mamadou Fofana,ml MLI,DF,Metz,fr Ligue 1,23,1998,0,1,1,0,1,0,1,2,50.0,1,2,1,1,1,2,2,0
Seko Fofana,ci CIV,MF,Lens,fr Ligue 1,26,1995,37,27,19,11,13,3,12,58,20.7,46,24,2,22,26,53,17,1
Wesley Fofana,fr FRA,DF,Leicester City,eng Premier League,20,2000,7,12,8,11,1,0,7,11,63.6,4,5,2,3,12,24,26,1
Youssouf Fofana,fr FRA,MF,Monaco,fr Ligue 1,22,1999,24,69,43,19,41,9,29,56,51.8,27,29,7,22,32,101,22,2
Thomas Foket,be BEL,DFFW,Reims,fr Ligue 1,26,1994,25,28,19,12,13,3,18,40,45.0,22,26,4,22,33,61,35,0
Thomas Fontaine,mg MAD,DF,Lorient,fr Ligue 1,30,1991,2,2,0,1,0,1,0,1,0.0,1,3,3,0,2,4,4,0
José Fontán,es ESP,DF,Celta Vigo,es La Liga,21,2000,3,5,3,3,2,0,1,5,20.0,4,3,1,2,10,15,10,0
José Fonte,pt POR,DF,Lille,fr Ligue 1,37,1983,38,23,12,14,7,2,11,25,44.0,14,39,32,7,44,67,159,1
Fernando Forestieri,it ITA,FWMF,Udinese,it Serie A,31,1990,1,0,0,0,0,0,0,1,0.0,1,1,0,1,0,0,1,0
Pablo Fornals,es ESP,FWMF,West Ham,eng Premier League,25,1996,31,54,28,21,21,12,22,84,26.2,62,49,2,47,27,81,16,1
Emil Forsberg,se SWE,MF,RB Leipzig,de Bundesliga,29,1991,19,21,12,2,11,8,7,22,31.8,15,18,0,18,2,23,2,1
Adam Forshaw,eng ENG,MF,Leeds United,eng Premier League,29,1991,17,53,23,21,27,5,21,54,38.9,33,17,1,16,19,72,12,2
Marcus Forss,fi FIN,FWMF,Brentford,eng Premier League,22,1999,2,3,3,0,2,1,2,4,50.0,2,5,0,5,1,4,0,0
Fraser Forster,eng ENG,GK,Southampton,eng Premier League,33,1988,19,1,0,1,0,0,0,1,0.0,1,0,0,0,0,1,23,2
Philipp Förster,de GER,MFFW,Stuttgart,de Bundesliga,26,1995,11,20,13,4,12,4,11,26,42.3,15,12,1,11,3,23,2,0
Francesco Forte,it ITA,FW,Venezia,it Serie A,28,1993,5,3,2,0,2,1,2,5,40.0,3,1,0,1,0,3,2,0
Steven Fortes,cv CPV,DF,Lens,fr Ligue 1,29,1992,1,2,0,2,0,0,1,2,50.0,1,2,1,1,0,2,4,0
Ben Foster,eng ENG,GK,Watford,eng Premier League,38,1983,26,0,0,0,0,0,0,3,0.0,3,0,0,0,0,0,9,4
Tariqe Fosu,gh GHA,DF,Brentford,eng Premier League,25,1995,0,0,0,0,0,0,0,0,,0,1,0,1,0,0,0,0
Timothy Fosu-Mensah,nl NED,DF,Leverkusen,de Bundesliga,23,1998,2,5,3,3,1,1,4,4,100.0,0,1,0,1,2,7,2,0
Dimitri Foulquier,fr FRA,DF,Granada,es La Liga,28,1993,2,0,0,0,0,0,0,1,0.0,1,2,1,1,1,1,2,0
Dimitri Foulquier,fr FRA,DF,Valencia,es La Liga,28,1993,26,36,17,17,15,4,21,34,61.8,13,19,3,16,29,65,49,0
Juan Foyth,ar ARG,DF,Villarreal,es La Liga,23,1998,21,69,49,35,28,6,35,47,74.5,12,29,7,22,20,89,50,0
Gianluca Frabotta,it ITA,DFMF,Hellas Verona,it Serie A,22,1999,0,0,0,0,0,0,0,1,0.0,1,1,0,1,1,1,0,0
Raphael Framberger,de GER,DF,Augsburg,de Bundesliga,25,1995,9,26,19,12,10,4,13,27,48.1,14,8,2,6,9,35,25,0
Przemysław Frankowski,pl POL,DF,Lens,fr Ligue 1,26,1995,27,57,39,22,27,8,36,74,48.6,38,27,0,27,28,85,52,0
Enric Franquesa,es ESP,DFFW,Levante,es La Liga,24,1997,7,5,3,4,0,1,0,1,0.0,1,4,0,4,7,12,11,0
Fransérgio,br BRA,MF,Bordeaux,fr Ligue 1,30,1990,14,24,10,8,12,4,12,43,27.9,31,18,6,12,23,47,23,0
Ryan Fraser,sct SCO,FWMF,Newcastle Utd,eng Premier League,27,1994,16,10,3,5,3,2,5,13,38.5,8,11,1,10,11,21,11,0
Davide Frattesi,it ITA,MF,Sassuolo,it Serie A,21,1999,32,46,16,26,18,2,26,52,50.0,26,44,12,32,29,75,62,1
Fred,br BRA,MF,Manchester Utd,eng Premier League,28,1993,23,63,27,32,24,7,22,79,27.8,57,38,11,27,32,95,24,0
Ryan Fredericks,eng ENG,DF,West Ham,eng Premier League,28,1992,3,2,2,2,0,0,0,1,0.0,1,2,1,1,4,6,6,0
Morten Frendrup,dk DEN,DFMF,Genoa,it Serie A,20,2001,8,40,24,19,13,8,13,29,44.8,16,19,2,17,17,57,7,1
Remo Freuler,ch SUI,MF,Atalanta,it Serie A,29,1992,26,69,39,22,33,14,30,70,42.9,40,48,8,40,35,104,26,1
Marvin Friedrich,de GER,DF,M'Gladbach,de Bundesliga,25,1995,7,14,8,10,4,0,9,11,81.8,2,5,3,2,5,19,26,0
Marvin Friedrich,de GER,DF,Union Berlin,de Bundesliga,25,1995,13,17,5,14,3,0,10,16,62.5,6,13,7,6,23,40,47,0
Jeremie Frimpong,nl NED,DF,Leverkusen,de Bundesliga,20,2000,23,32,18,19,12,1,12,23,52.2,11,24,6,18,17,49,40,2
Christian Früchtl,de GER,GK,Bayern Munich,de Bundesliga,21,2000,0,0,0,0,0,0,0,0,,0,0,0,0,0,0,0,0
Jorge de Frutos,es ESP,MFFW,Levante,es La Liga,24,1997,20,33,15,14,11,8,10,51,19.6,41,11,1,10,12,45,13,0
Leo Fuhr Hjelde,no NOR,MFDF,Leeds United,eng Premier League,17,2003,2,5,4,3,2,0,3,3,100.0,0,3,3,0,4,9,7,0
Chris Führich,de GER,FWMF,Stuttgart,de Bundesliga,23,1998,19,28,16,10,10,8,18,39,46.2,21,31,2,29,8,36,9,0
Angelo Fulgini,fr FRA,MFFW,Angers,fr Ligue 1,24,1996,33,35,25,8,18,9,14,44,31.8,30,21,5,16,22,57,5,1
Marius Funk,de GER,GK,Greuther Fürth,de Bundesliga,25,1996,8,0,0,0,0,0,0,0,,0,0,0,0,0,0,8,1
Stephan Fürstner,de GER,MF,Mainz 05,de Bundesliga,33,1987,0,0,0,0,0,0,0,2,0.0,2,0,0,0,0,0,1,0
Matteo Gabbia,it ITA,DF,Milan,it Serie A,21,1999,6,4,3,1,3,0,0,4,0.0,4,2,2,0,8,12,12,0
Manolo Gabbiadini,it ITA,FWMF,Sampdoria,it Serie A,29,1991,13,6,4,3,2,1,1,7,14.3,6,5,2,3,3,9,10,0
Mijat Gaćinović,rs SRB,FWMF,Hoffenheim,de Bundesliga,26,1995,1,3,3,1,1,1,3,3,100.0,0,1,0,1,1,4,2,0
Gianluca Gaetano,it ITA,MF,Napoli,it Serie A,21,2000,0,1,1,1,0,0,1,2,50.0,1,0,0,0,2,3,0,0
Luca Gagliano,it ITA,FWDF,Cagliari,it Serie A,21,2000,0,0,0,0,0,0,0,0,,0,1,0,1,0,0,1,0
Roberto Gagliardini,it ITA,MF,Inter,it Serie A,27,1994,7,12,6,7,4,1,1,13,7.7,12,14,5,9,9,21,7,0
Riccardo Gagliolo,se SWE,DF,Salernitana,it Serie A,31,1990,13,23,12,16,4,3,16,27,59.3,11,15,8,7,28,51,52,0
Javi Galán,es ESP,DF,Celta Vigo,es La Liga,26,1994,37,108,66,60,37,11,42,99,42.4,57,48,8,40,45,153,52,0
Iñigo Ruiz de Galarreta,es ESP,MF,Mallorca,es La Liga,27,1993,15,40,21,14,21,5,14,30,46.7,16,16,2,14,20,60,21,0
Nicolas Galazzi,it ITA,MF,Venezia,it Serie A,20,2000,0,2,1,1,0,1,0,1,0.0,1,0,0,0,0,2,0,0
Pablo Galdames Millán,cl CHI,MF,Genoa,it Serie A,24,1996,11,28,12,6,16,6,12,35,34.3,23,16,2,14,8,36,9,1
Thiago Galhardo,br BRA,FWMF,Celta Vigo,es La Liga,32,1989,13,12,6,3,3,6,2,12,16.7,10,15,2,13,6,18,9,0
Conor Gallagher,eng ENG,MF,Crystal Palace,eng Premier League,21,2000,32,68,37,34,20,14,21,69,30.4,48,58,9,49,29,97,26,0
Gauthier Gallon,fr FRA,GK,Troyes,fr Ligue 1,28,1993,31,3,0,3,0,0,1,1,100.0,0,0,0,0,2,5,12,1
Cristian Gamboa,cr CRC,DF,Bochum,de Bundesliga,31,1989,19,59,36,40,16,3,30,61,49.2,31,22,7,15,32,91,35,1
Kévin Gameiro,fr FRA,FW,Strasbourg,fr Ligue 1,34,1987,27,19,10,5,9,5,6,18,33.3,12,22,1,21,6,25,1,0
Idrissa Gana Gueye,sn SEN,MF,Paris S-G,fr Ligue 1,31,1989,18,60,36,24,24,12,18,44,40.9,26,23,4,19,24,84,13,0
Ignatius Ganago,cm CMR,FW,Lens,fr Ligue 1,22,1999,11,3,2,1,2,0,2,6,33.3,4,4,0,4,2,5,3,0
Silvère Ganvoula M'Boussy,cg CGO,FW,Bochum,de Bundesliga,25,1996,2,0,0,0,0,0,0,1,0.0,1,0,0,0,0,0,1,0
Álvaro García,es ESP,FWMF,Rayo Vallecano,es La Liga,28,1992,33,42,23,15,18,9,8,35,22.9,27,27,3,24,42,84,24,0
Dani García,es ESP,MF,Athletic Club,es La Liga,31,1990,24,36,22,15,17,4,14,47,29.8,33,27,10,17,24,60,41,1
David García,es ESP,DF,Osasuna,es La Liga,27,1994,35,28,14,15,11,2,12,22,54.5,10,27,21,6,52,80,168,0
Eric García,es ESP,DF,Barcelona,es La Liga,20,2001,23,27,18,13,13,1,11,26,42.3,15,22,12,10,44,71,53,3
Francisco Garcia,es ESP,DF,Rayo Vallecano,es La Liga,21,1999,34,60,35,44,12,4,39,73,53.4,34,34,8,26,45,105,53,0
Joan García,es ESP,GK,Espanyol,es La Liga,20,2001,1,0,0,0,0,0,0,0,,0,0,0,0,1,1,1,2
Manu García,es ESP,MF,Alavés,es La Liga,23,1998,12,18,9,6,9,3,9,27,33.3,18,8,2,6,13,31,4,0
Raúl García,es ESP,FW,Athletic Club,es La Liga,35,1986,20,27,17,6,11,10,8,36,22.2,28,30,4,26,9,36,21,0
Rubén García,es ESP,MFFW,Osasuna,es La Liga,28,1993,26,43,26,12,23,8,16,49,32.7,33,31,4,27,24,67,16,0
Saúl García,es ESP,MF,Alavés,es La Liga,26,1994,0,1,1,1,0,0,0,0,,0,0,0,0,0,1,0,0
Unai García,es ESP,DF,Osasuna,es La Liga,29,1992,16,21,12,14,6,1,14,17,82.4,3,19,11,8,22,43,78,0
Alejandro Garnacho,es ESP,FWMF,Manchester Utd,eng Premier League,17,2004,0,0,0,0,0,0,0,1,0.0,1,0,0,0,0,0,0,0
Mario Gaspar,es ESP,DF,Villarreal,es La Liga,30,1990,7,10,4,2,5,3,6,10,60.0,4,6,3,3,6,16,15,0
Djeidi Gassama,fr FRA,FW,Paris S-G,fr Ligue 1,17,2003,0,0,0,0,0,0,0,0,,0,1,1,0,0,0,0,0
Johan Gastien,fr FRA,MF,Clermont Foot,fr Ligue 1,33,1988,31,56,34,26,25,5,27,74,36.5,47,45,11,34,53,109,49,1
Gavi,es ESP,MFFW,Barcelona,es La Liga,16,2004,26,38,18,13,18,7,9,33,27.3,24,36,0,36,25,63,13,0
Dwight Gayle,eng ENG,FWDF,Newcastle Utd,eng Premier League,30,1990,0,1,0,0,1,0,0,1,0.0,1,0,0,0,1,2,0,0
Jean-Philippe Gbamin,ci CIV,MF,Everton,eng Premier League,25,1995,1,1,1,1,0,0,0,2,0.0,2,0,0,0,1,2,1,0
David de Gea,es ESP,GK,Manchester Utd,eng Premier League,30,1990,38,0,0,0,0,0,0,0,,0,0,0,0,0,0,11,2
Linus Gechter,de GER,DF,Hertha BSC,de Bundesliga,17,2004,8,15,8,13,2,0,7,14,50.0,7,12,7,5,11,26,29,0
Dennis Geiger,de GER,MF,Hoffenheim,de Bundesliga,23,1998,15,34,23,9,20,5,17,30,56.7,13,15,1,14,14,48,7,1
Joe Gelhardt,eng ENG,FWMF,Leeds United,eng Premier League,19,2002,8,4,3,1,0,3,2,10,20.0,8,9,0,9,0,4,3,0
Luca Gemello,it ITA,GK,Torino,it Serie A,21,2000,1,0,0,0,0,0,0,0,,0,0,0,0,0,0,0,0
Yannick Gerhardt,de GER,MFDF,Wolfsburg,de Bundesliga,27,1994,18,42,20,18,17,7,22,36,61.1,14,24,1,23,25,67,25,1
Valère Germain,fr FRA,FW,Montpellier,fr Ligue 1,31,1990,22,23,14,6,11,6,8,31,25.8,23,13,1,12,9,32,27,0
Gerson,br BRA,MFFW,Marseille,fr Ligue 1,24,1997,28,42,17,16,20,6,8,35,22.9,27,26,4,22,16,58,16,2
Willem Geubbels,fr FRA,FWMF,Nantes,fr Ligue 1,19,2001,6,8,5,4,2,2,5,12,41.7,7,5,0,5,6,14,5,0
Hamadi Al Ghaddioui,ma MAR,FW,Stuttgart,de Bundesliga,30,1990,6,5,4,2,1,2,0,4,0.0,4,3,1,2,0,5,4,0
Ismaël Gharbi,es ESP,FW,Paris S-G,fr Ligue 1,17,2004,0,0,0,0,0,0,0,0,,0,0,0,0,0,0,0,0
Anwar El Ghazi,nl NED,FWMF,Aston Villa,eng Premier League,26,1995,4,4,4,2,2,0,2,7,28.6,5,6,0,6,1,5,2,0
Anwar El Ghazi,nl NED,FWMF,Everton,eng Premier League,26,1995,0,1,1,1,0,0,1,1,100.0,0,3,0,3,0,1,0,0
Lamine Ghezali,fr FRA,DF,Saint-Étienne,fr Ligue 1,22,1999,0,0,0,0,0,0,0,0,,0,1,0,1,0,0,0,0
Paolo Ghiglione,it ITA,DF,Genoa,it Serie A,24,1997,7,17,12,8,6,3,9,14,64.3,5,11,5,6,10,27,12,1
Saman Ghoddos,ir IRN,MFDF,Brentford,eng Premier League,27,1993,6,17,10,8,6,3,9,15,60.0,6,2,0,2,3,20,16,0
Faouzi Ghoulam,dz ALG,DF,Napoli,it Serie A,30,1991,4,3,1,1,2,0,0,3,0.0,3,2,1,1,3,6,10,0
Dimitris Giannoulis,gr GRE,DF,Norwich City,eng Premier League,25,1995,13,36,21,17,17,2,24,36,66.7,12,22,6,16,19,55,41,1
Morgan Gibbs-White,eng ENG,DFFW,Wolves,eng Premier League,21,2000,0,0,0,0,0,0,0,0,,0,1,0,1,0,0,0,0
Ben Gibson,eng ENG,DF,Norwich City,eng Premier League,28,1993,28,23,16,17,6,0,7,12,58.3,5,36,30,6,27,50,139,2
Niko Gießelmann,de GER,DFFW,Union Berlin,de Bundesliga,29,1991,23,24,17,10,11,3,15,38,39.5,23,26,4,22,18,42,29,1
Rafał Gikiewicz,pl POL,GK,Augsburg,de Bundesliga,33,1987,34,2,0,2,0,0,2,7,28.6,5,0,0,0,3,5,11,5
Óscar Gil,es ESP,DF,Espanyol,es La Liga,24,1997,19,52,35,27,20,5,25,46,54.3,21,33,9,24,19,71,33,2
Mario Gila,es ESP,DF,Real Madrid,es La Liga,20,2000,0,1,0,1,0,0,0,1,0.0,1,0,0,0,1,2,1,0
Billy Gilmour,sct SCO,MF,Norwich City,eng Premier League,20,2001,21,41,21,16,21,4,14,52,26.9,38,21,4,17,17,58,29,0
Daniel Ginczek,de GER,MFFW,Wolfsburg,de Bundesliga,30,1991,0,0,0,0,0,0,0,0,,0,0,0,0,0,0,0,0
Matthias Ginter,de GER,DF,M'Gladbach,de Bundesliga,27,1994,26,37,22,21,13,3,28,42,66.7,14,22,11,11,34,71,79,0
Nicholas Gioacchini,us USA,FWMF,Montpellier,fr Ligue 1,21,2000,6,7,5,3,2,2,4,10,40.0,6,8,0,8,4,11,5,0
Sebastian Giovinco,it ITA,MF,Sampdoria,it Serie A,34,1987,0,0,0,0,0,0,0,1,0.0,1,0,0,0,0,0,0,0
Jimmy Giraudon,fr FRA,DF,Troyes,fr Ligue 1,29,1992,18,14,6,10,4,0,7,22,31.8,15,24,14,10,37,51,68,1
Andrei Girotto,br BRA,DFMF,Nantes,fr Ligue 1,29,1992,35,85,52,49,32,4,52,103,50.5,51,67,33,34,69,154,143,0
Olivier Giroud,fr FRA,FW,Milan,it Serie A,34,1986,21,15,11,4,6,5,3,17,17.6,14,13,4,9,3,18,19,0
Serge Gnabry,de GER,FWDF,Bayern Munich,de Bundesliga,26,1995,24,47,31,16,20,11,22,57,38.6,35,26,0,26,14,61,3,0
Ben Godfrey,eng ENG,DF,Everton,eng Premier League,23,1998,23,47,32,29,14,4,24,39,61.5,15,41,19,22,15,62,100,2
Diego Godín,uy URU,DF,Cagliari,it Serie A,35,1986,9,18,7,13,3,2,10,15,66.7,5,7,5,2,13,31,46,0
Edoardo Goldaniga,it ITA,DF,Cagliari,it Serie A,27,1993,10,12,5,7,5,0,4,11,36.4,7,8,5,3,22,34,23,0
Edoardo Goldaniga,it ITA,DFMF,Sassuolo,it Serie A,27,1993,0,0,0,0,0,0,0,0,,0,0,0,0,0,0,0,0
Aleksandr Golovin,ru RUS,FWMF,Monaco,fr Ligue 1,25,1996,17,40,22,10,18,12,18,41,43.9,23,26,1,25,12,52,8,0
André Gomes,pt POR,MF,Everton,eng Premier League,28,1993,7,16,4,6,6,4,8,32,25.0,24,8,2,6,1,17,7,1
Angel Gomes,eng ENG,MFFW,Lille,fr Ligue 1,20,2000,11,23,13,6,12,5,10,15,66.7,5,4,0,4,3,26,4,0
Toti Gomes,pt POR,DF,Wolves,eng Premier League,22,1999,4,11,7,10,1,0,7,9,77.8,2,6,3,3,8,19,15,0
Dani Gómez,es ESP,FW,Levante,es La Liga,23,1998,12,7,4,3,2,2,4,12,33.3,8,3,0,3,3,10,5,0
Joe Gomez,eng ENG,DF,Liverpool,eng Premier League,24,1997,4,10,6,5,2,3,5,9,55.6,4,4,1,3,5,15,6,0
Maxi Gómez,uy URU,FW,Valencia,es La Liga,24,1996,22,5,3,1,2,2,5,8,62.5,3,5,1,4,3,8,22,0
Moi Gómez,es ESP,MFFW,Villarreal,es La Liga,27,1994,14,15,7,8,3,4,5,17,29.4,12,5,0,5,6,21,6,0
Papu Gómez,ar ARG,FWMF,Sevilla,es La Liga,33,1988,20,19,11,9,5,5,9,35,25.7,26,15,2,13,7,26,12,2
Sergi Gómez,es ESP,DF,Espanyol,es La Liga,29,1992,30,33,24,29,3,1,18,27,66.7,9,33,23,10,40,73,125,2
Alfred Gomis,sn SEN,GK,Rennes,fr Ligue 1,27,1993,25,1,0,1,0,0,1,2,50.0,1,0,0,0,1,2,8,2
Maxime Gonalons,fr FRA,MF,Granada,es La Liga,32,1989,17,43,28,17,22,4,14,39,35.9,25,33,10,23,18,61,29,0
Vagner Gonçalves,cv CPV,FW,Metz,fr Ligue 1,25,1996,1,2,1,0,2,0,1,1,100.0,0,0,0,0,1,3,0,0
Cedric Gondo,ci CIV,FW,Salernitana,it Serie A,24,1996,8,5,2,2,2,1,2,5,40.0,3,2,0,2,3,8,2,0
Álvaro González,es ESP,DF,Marseille,fr Ligue 1,31,1990,5,1,1,1,0,0,1,1,100.0,0,0,0,0,1,2,9,0
Diego González,es ESP,DF,Elche,es La Liga,26,1995,20,25,16,18,7,0,9,16,56.3,7,21,13,8,19,44,87,0
Édgar González,es ESP,DF,Betis,es La Liga,24,1997,16,25,19,15,8,2,17,24,70.8,7,17,11,6,23,48,82,0
Giovanni González,uy URU,DF,Mallorca,es La Liga,26,1994,4,9,3,4,4,1,3,5,60.0,2,7,2,5,4,13,14,0
Nicolás González,ar ARG,FW,Fiorentina,it Serie A,23,1998,26,21,16,6,8,7,9,28,32.1,19,26,2,24,21,42,4,1
Nicolás González,es ESP,MF,Barcelona,es La Liga,19,2002,12,31,20,5,23,3,11,27,40.7,16,12,0,12,6,37,12,0
Peter González,do DOM,MFDF,Real Madrid,es La Liga,19,2002,0,0,0,0,0,0,0,0,,0,0,0,0,1,1,0,0
Roberto González,es ESP,FWMF,Betis,es La Liga,20,2001,2,5,4,3,2,0,4,6,66.7,2,5,0,5,1,6,1,0
Charlie Goode,eng ENG,DF,Brentford,eng Premier League,25,1995,5,7,5,5,2,0,4,4,100.0,0,4,2,2,2,9,8,0
Anthony Gordon,eng ENG,MFFW,Everton,eng Premier League,20,2001,25,54,32,20,30,4,21,59,35.6,38,49,3,46,22,76,17,0
Kaide Gordon,eng ENG,FW,Liverpool,eng Premier League,16,2004,0,1,0,0,0,1,0,0,,0,0,0,0,0,1,0,0
Leon Goretzka,de GER,MF,Bayern Munich,de Bundesliga,26,1995,16,25,15,12,9,4,11,26,42.3,15,11,1,10,17,42,23,2
Gori,es ESP,MF,Espanyol,es La Liga,19,2002,0,0,0,0,0,0,0,0,,0,2,0,2,0,0,0,0
Andoni Gorosabel,es ESP,DF,Real Sociedad,es La Liga,24,1996,25,47,31,32,9,6,25,47,53.2,22,16,3,13,18,65,49,0
Robin Gosens,de GER,DF,Atalanta,it Serie A,27,1994,5,7,3,3,4,0,4,8,50.0,4,4,0,4,9,16,1,0
Robin Gosens,de GER,DF,Inter,it Serie A,27,1994,2,3,1,1,2,0,0,0,,0,5,2,3,3,6,3,0
Dan Gosling,eng ENG,MF,Watford,eng Premier League,31,1990,2,2,1,1,1,0,2,6,33.3,4,2,0,2,0,2,3,0
Amine Gouiri,fr FRA,FWMF,Nice,fr Ligue 1,21,2000,31,22,13,2,13,7,10,32,31.3,22,22,5,17,11,33,17,1
Lucas Gourna-Douath,fr FRA,MF,Saint-Étienne,fr Ligue 1,17,2003,20,45,26,22,18,5,21,36,58.3,15,22,3,19,13,58,9,2
Jeffrey Gouweleeuw,nl NED,DF,Augsburg,de Bundesliga,30,1991,29,50,27,33,17,0,22,36,61.1,14,35,18,17,49,99,116,0
Jonathan Gradit,fr FRA,DF,Lens,fr Ligue 1,28,1992,34,60,28,24,28,8,25,45,55.6,20,39,27,12,65,125,106,0
Jens Grahl,de GER,GK,Eint Frankfurt,de Bundesliga,32,1988,1,0,0,0,0,0,0,0,,0,0,0,0,0,0,1,0
Alberto Grassi,it ITA,MF,Cagliari,it Serie A,26,1995,24,47,26,13,30,4,16,38,42.1,22,27,9,18,63,110,33,1
Jaume Grau,es ESP,MF,Osasuna,es La Liga,24,1997,0,1,1,1,0,0,0,1,0.0,1,0,0,0,0,1,0,0
Andrew Gravillon,gp GLP,DF,Reims,fr Ligue 1,23,1998,24,32,24,19,13,0,17,27,63.0,10,25,15,10,33,65,83,1
Demarai Gray,eng ENG,MFFW,Everton,eng Premier League,25,1996,26,30,19,13,10,7,10,22,45.5,12,30,2,28,15,45,21,1
Adrian Grbić,at AUT,FWMF,Lorient,fr Ligue 1,24,1996,6,2,1,0,2,0,2,6,33.3,4,3,1,2,0,2,7,0
Ivo Grbić,hr CRO,GK,Lille,fr Ligue 1,25,1996,21,0,0,0,0,0,0,0,,0,0,0,0,0,0,14,1
Jack Grealish,eng ENG,FW,Manchester City,eng Premier League,25,1995,21,18,17,4,10,4,5,13,38.5,8,11,1,10,8,26,7,0
Etienne Green,eng ENG,GK,Saint-Étienne,fr Ligue 1,21,2000,13,1,1,1,0,0,0,0,,0,0,0,0,1,2,9,0
Julian Green,us USA,MF,Greuther Fürth,de Bundesliga,26,1995,12,9,5,0,8,1,2,8,25.0,6,10,2,8,7,16,10,0
Mason Greenwood,eng ENG,FWMF,Manchester Utd,eng Premier League,19,2001,14,15,9,9,1,5,3,9,33.3,6,5,0,5,1,16,6,0
Sam Greenwood,eng ENG,MFFW,Leeds United,eng Premier League,19,2002,3,8,5,0,5,3,4,7,57.1,3,3,0,3,2,10,1,0
Michael Gregoritsch,at AUT,FWMF,Augsburg,de Bundesliga,27,1994,16,19,8,4,10,5,2,15,13.3,13,18,2,16,6,25,30,0
Dominik Greif,sk SVK,GK,Mallorca,es La Liga,24,1997,1,0,0,0,0,0,0,0,,0,0,0,0,0,0,0,0
Clément Grenier,fr FRA,MF,Mallorca,es La Liga,30,1991,1,0,0,0,0,0,0,0,,0,1,1,0,0,0,1,0
Sebastian Griesbeck,de GER,DFMF,Greuther Fürth,de Bundesliga,30,1990,27,60,31,38,19,3,39,62,62.9,23,38,13,25,43,103,100,1
Sebastian Griesbeck,de GER,MF,Union Berlin,de Bundesliga,30,1990,0,1,1,0,1,0,1,1,100.0,0,0,0,0,0,1,0,0
Antoine Griezmann,fr FRA,FW,Barcelona,es La Liga,30,1991,3,13,5,3,10,0,2,6,33.3,4,4,0,4,3,16,5,0
Antoine Griezmann,fr FRA,FWMF,Atlético Madrid,es La Liga,30,1991,19,30,14,11,15,4,12,32,37.5,20,18,1,17,7,37,18,0
Vincenzo Grifo,it ITA,MFFW,Freiburg,de Bundesliga,28,1993,31,27,15,9,13,5,9,26,34.6,17,12,2,10,13,40,28,0
Lennart Grill,de GER,GK,Leverkusen,de Bundesliga,22,1999,1,0,0,0,0,0,0,0,,0,0,0,0,0,0,0,0
Florian Grillitsch,at AUT,DFMF,Hoffenheim,de Bundesliga,25,1995,17,37,19,15,21,1,17,31,54.8,14,18,7,11,29,66,36,1
Arnaut Groeneveld,nl NED,FW,Villarreal,es La Liga,24,1997,16,7,6,3,0,4,2,4,50.0,2,5,0,5,2,9,3,0
Pascal Groß,de GER,MFDF,Brighton,eng Premier League,30,1991,23,28,15,15,11,2,12,33,36.4,21,34,8,26,18,46,23,0
Carlos Gruezo,ec ECU,MF,Augsburg,de Bundesliga,26,1995,11,22,11,10,10,2,8,21,38.1,13,11,2,9,9,31,15,0
Vicente Guaita,es ESP,GK,Crystal Palace,eng Premier League,34,1987,30,1,0,1,0,0,1,1,100.0,0,0,0,0,1,2,8,1
Andrés Guardado,mx MEX,MF,Betis,es La Liga,34,1986,16,30,13,12,17,1,13,34,38.2,21,18,4,14,21,51,29,1
Sergi Guardiola,es ESP,FW,Rayo Vallecano,es La Liga,30,1991,19,10,9,3,5,2,1,21,4.8,20,14,2,12,4,14,17,0
Nemanja Gudelj,rs SRB,DFMF,Sevilla,es La Liga,29,1991,12,16,7,10,4,2,5,8,62.5,3,14,9,5,22,38,37,0
Gabriel Gudmundsson,se SWE,DFMF,Lille,fr Ligue 1,22,1999,15,43,31,24,16,3,17,35,48.6,18,15,3,12,20,63,13,0
Noah Guede-Nadje,fr FRA,MF,Angers,fr Ligue 1,17,2003,0,0,0,0,0,0,0,0,,0,0,0,0,0,0,0,0
Gonçalo Guedes,pt POR,FWMF,Valencia,es La Liga,24,1996,29,21,14,6,7,8,2,22,9.1,20,14,0,14,9,30,1,0
Marc Guéhi,eng ENG,DF,Crystal Palace,eng Premier League,21,2000,36,35,17,24,10,1,15,16,93.8,1,34,26,8,30,65,127,0
Mattéo Guendouzi,fr FRA,MF,Marseille,fr Ligue 1,22,1999,35,45,30,10,26,9,13,47,27.7,34,15,1,14,16,61,18,0
Yanis Guermouche,fr FRA,MFFW,Montpellier,fr Ligue 1,20,2001,0,2,1,0,1,1,1,1,100.0,0,0,0,0,0,2,0,0
Raphaël Guerreiro,pt POR,DF,Dortmund,de Bundesliga,27,1993,20,35,19,19,12,4,16,31,51.6,15,18,2,16,25,60,14,1
Evann Guessand,fr FRA,FW,Nice,fr Ligue 1,20,2001,5,9,8,2,5,2,3,8,37.5,5,4,0,4,0,9,1,0
Ander Guevara,es ESP,MF,Real Sociedad,es La Liga,24,1997,10,18,13,6,10,2,10,17,58.8,7,12,6,6,12,30,8,0
Lamine Gueye,sn SEN,FWMF,Metz,fr Ligue 1,23,1998,6,5,5,1,1,3,3,7,42.9,4,4,0,4,6,11,1,0
Pape Gueye,sn SEN,MF,Marseille,fr Ligue 1,22,1999,17,38,19,15,22,1,16,31,51.6,15,15,3,12,24,62,16,0
John Guidetti,se SWE,FWMF,Alavés,es La Liga,29,1992,3,2,1,0,0,2,0,1,0.0,1,1,0,1,0,2,0,0
Josuha Guilavogui,fr FRA,MFDF,Bordeaux,fr Ligue 1,30,1990,15,39,16,18,17,4,14,29,48.3,15,16,8,8,36,75,23,0
Josuha Guilavogui,fr FRA,MFDF,Wolfsburg,de Bundesliga,30,1990,11,23,14,13,9,1,7,18,38.9,11,11,6,5,25,48,42,0
Frederic Guilbert,fr FRA,DF,Strasbourg,fr Ligue 1,26,1994,28,69,39,33,24,12,32,62,51.6,30,37,11,26,55,124,39,0
Hugo Guillamón,es ESP,MFDF,Valencia,es La Liga,21,2000,26,43,27,20,16,7,18,44,40.9,26,26,10,16,30,73,53,1
Bruno Guimarães,br BRA,MF,Newcastle Utd,eng Premier League,23,1997,12,44,23,18,22,4,21,38,55.3,17,25,6,19,9,53,13,0
Bruno Guimarães,br BRA,MF,Lyon,fr Ligue 1,23,1997,18,50,31,20,25,5,23,59,39.0,36,21,4,17,21,71,11,1
Sehrou Guirassy,gn GUI,FW,Rennes,fr Ligue 1,25,1996,11,4,2,1,2,1,1,7,14.3,6,4,0,4,1,5,8,0
Péter Gulácsi,hu HUN,GK,RB Leipzig,de Bundesliga,31,1990,33,0,0,0,0,0,0,0,,0,0,0,0,1,1,15,1
Manuel Gulde,de GER,DF,Freiburg,de Bundesliga,30,1991,14,18,10,14,3,1,8,11,72.7,3,16,8,8,17,35,37,0
Gerard Gumbau,es ESP,MF,Elche,es La Liga,26,1994,21,46,19,22,19,5,22,51,43.1,29,18,4,14,23,69,25,0
Robert Gumny,pl POL,DF,Augsburg,de Bundesliga,23,1998,25,48,29,25,20,3,25,43,58.1,18,24,7,17,28,76,57,3
İlkay Gündoğan,de GER,MF,Manchester City,eng Premier League,30,1990,21,23,9,10,12,1,12,31,38.7,19,11,1,10,15,38,10,0
Angus Gunn,eng ENG,GK,Norwich City,eng Premier League,25,1996,9,0,0,0,0,0,0,0,,0,0,0,0,0,0,11,0
Christian Günter,de GER,DFMF,Freiburg,de Bundesliga,28,1993,34,34,20,16,15,3,18,50,36.0,32,23,6,17,17,51,49,2
Koray Günter,de GER,DF,Hellas Verona,it Serie A,26,1994,27,32,18,19,11,2,16,32,50.0,16,27,21,6,69,101,110,1
Lasse Günther,de GER,DF,Augsburg,de Bundesliga,18,2003,2,8,5,4,3,1,5,9,55.6,4,0,0,0,2,10,2,0
Jon Guridi,es ESP,MF,Real Sociedad,es La Liga,26,1995,2,5,3,2,3,0,1,4,25.0,3,3,1,2,3,8,4,0
Malo Gusto,fr FRA,DF,Lyon,fr Ligue 1,18,2003,21,55,35,29,21,5,24,40,60.0,16,21,6,15,33,88,41,1
Raúl Guti,es ESP,MF,Elche,es La Liga,24,1996,18,25,15,7,14,4,10,30,33.3,20,9,3,6,25,50,7,0
Marcos Mauro López Gutiérrez,ar ARG,DF,Cádiz,es La Liga,30,1991,2,1,0,0,1,0,0,2,0.0,2,2,1,1,1,2,9,0
Miguel Gutiérrez,es ESP,DF,Real Madrid,es La Liga,20,2001,3,7,5,5,0,2,3,5,60.0,2,0,0,0,2,9,2,0
Albert Guðmundsson,is ISL,FWMF,Genoa,it Serie A,24,1997,7,5,3,2,1,2,3,8,37.5,5,2,0,2,5,10,4,0
Joško Gvardiol,hr CRO,DF,RB Leipzig,de Bundesliga,19,2002,27,47,31,28,17,2,22,39,56.4,17,30,11,19,51,98,62,2
Emmanuel Gyasi,gh GHA,FWMF,Spezia,it Serie A,27,1994,34,47,30,31,9,7,21,41,51.2,20,22,4,18,16,63,43,1
Norbert Gyömbér,sk SVK,DF,Salernitana,it Serie A,29,1992,29,53,32,40,11,2,33,50,66.0,17,38,24,14,44,97,126,1
Erling Haaland,no NOR,FW,Dortmund,de Bundesliga,21,2000,21,2,1,0,1,1,0,1,0.0,1,8,1,7,1,3,31,0
Nicolas Haas,ch SUI,MF,Empoli,it Serie A,25,1996,11,35,22,15,10,10,17,39,43.6,22,24,4,20,9,44,17,1
Janik Haberer,de GER,MF,Freiburg,de Bundesliga,27,1994,9,14,8,5,6,3,7,19,36.8,12,11,4,7,16,30,11,0
Alexander Hack,de GER,DF,Mainz 05,de Bundesliga,27,1993,23,52,26,35,17,0,29,46,63.0,17,31,14,17,51,103,95,1
Robin Hack,de GER,FWMF,Arminia,de Bundesliga,22,1998,15,14,8,6,5,3,3,21,14.3,18,18,1,17,5,19,4,0
Munir El Haddadi,ma MAR,FWMF,Sevilla,es La Liga,25,1995,5,8,4,1,6,1,2,8,25.0,6,7,1,6,5,13,2,0
André Hahn,de GER,MFFW,Augsburg,de Bundesliga,30,1990,23,35,20,9,14,12,16,49,32.7,33,38,5,33,15,50,43,0
Amadou Haidara,ml MLI,MF,RB Leipzig,de Bundesliga,23,1998,15,30,14,11,19,0,17,37,45.9,20,22,6,16,16,46,8,1
Massadio Haïdara,ml MLI,DF,Lens,fr Ligue 1,28,1992,12,28,21,18,7,3,15,24,62.5,9,18,4,14,22,50,31,0
Oualid El Hajjam,ma MAR,DF,Troyes,fr Ligue 1,30,1991,12,22,11,12,6,4,15,23,65.2,8,12,6,6,22,44,28,0
Achraf Hakimi,ma MAR,DF,Paris S-G,fr Ligue 1,22,1998,28,75,51,38,28,9,41,73,56.2,32,25,5,20,28,103,23,2
Marcel Halstenberg,de GER,DF,RB Leipzig,de Bundesliga,29,1991,6,10,7,6,4,0,6,11,54.5,5,6,0,6,7,17,11,0
Pierre-Yves Hamel,fr FRA,FWMF,Lorient,fr Ligue 1,27,1994,0,0,0,0,0,0,0,1,0.0,1,0,0,0,2,2,0,0
Pierre-Yves Hamel,fr FRA,FW,Clermont Foot,fr Ligue 1,27,1994,6,11,6,0,5,6,5,6,83.3,1,2,1,1,0,11,0,0
Romain Hamouma,fr FRA,FWMF,Saint-Étienne,fr Ligue 1,34,1987,10,10,7,1,5,4,2,13,15.4,11,8,0,8,4,14,1,0
Samir Handanović,si SVN,GK,Inter,it Serie A,37,1984,37,1,0,1,0,0,1,2,50.0,1,1,0,1,0,1,6,3
Grant Hanley,sct SCO,DF,Norwich City,eng Premier League,29,1991,32,44,25,28,14,2,18,35,51.4,17,56,45,11,56,100,176,2
Ridgeciano Haps,sr SUR,DF,Venezia,it Serie A,28,1993,23,36,20,26,4,6,11,21,52.4,10,34,12,22,29,65,57,1
Genki Haraguchi,jp JPN,MF,Union Berlin,de Bundesliga,30,1991,20,37,20,12,22,3,15,48,31.3,33,25,3,22,26,63,15,0
Amine Harit,ma MAR,FWMF,Marseille,fr Ligue 1,24,1997,13,18,11,9,9,0,9,17,52.9,8,10,0,10,4,22,2,0
Varazdat Haroyan,am ARM,DF,Cádiz,es La Liga,28,1992,16,31,21,20,10,1,19,29,65.5,10,22,12,10,15,46,62,0
Jack Harrison,eng ENG,FWMF,Leeds United,eng Premier League,24,1996,29,57,37,22,22,13,31,76,40.8,45,35,1,34,21,78,19,0
Abdou Harroui,nl NED,MF,Sassuolo,it Serie A,23,1998,5,11,4,4,7,0,8,11,72.7,3,14,0,14,4,15,5,0
Luis Hartwig,de GER,FW,Bochum,de Bundesliga,18,2002,0,0,0,0,0,0,0,0,,0,0,0,0,0,0,0,0
Makoto Hasebe,jp JPN,DF,Eint Frankfurt,de Bundesliga,37,1984,13,27,12,15,11,1,13,29,44.8,16,24,8,16,22,49,36,0
Hans Hateboer,nl NED,DFMF,Atalanta,it Serie A,27,1994,15,22,14,10,8,4,11,26,42.3,15,11,1,10,7,29,20,0
Kortney Hause,eng ENG,DF,Aston Villa,eng Premier League,26,1995,4,3,3,2,0,1,3,4,75.0,1,8,5,3,6,9,13,0
Kai Havertz,de GER,FWMF,Chelsea,eng Premier League,22,1999,20,17,8,5,7,5,4,14,28.6,10,28,1,27,4,21,32,1
Isaac Hayden,eng ENG,MFDF,Newcastle Utd,eng Premier League,26,1995,11,28,14,11,14,3,12,29,41.4,17,17,8,9,14,42,24,0
Eden Hazard,be BEL,FWMF,Real Madrid,es La Liga,30,1991,8,6,3,3,2,1,3,7,42.9,4,3,0,3,2,8,0,0
Thorgan Hazard,be BEL,FWDF,Dortmund,de Bundesliga,28,1993,15,23,13,8,10,5,15,40,37.5,25,23,1,22,6,29,4,0
Jonas Hector,de GER,DF,Köln,de Bundesliga,31,1990,28,76,39,36,26,14,29,74,39.2,45,59,8,51,50,126,68,1
Hwang Hee-chan,kr KOR,FWMF,Wolves,eng Premier League,25,1996,20,27,13,9,16,2,14,44,31.8,30,10,0,10,13,40,7,1
Hwang Hee-chan,kr KOR,FW,RB Leipzig,de Bundesliga,25,1996,1,0,0,0,0,0,0,0,,0,0,0,0,1,1,0,0
Silvan Hefti,ch SUI,DF,Genoa,it Serie A,23,1997,14,50,30,23,22,5,32,58,55.2,26,20,4,16,20,70,34,1
Dominique Heintz,de GER,DF,Union Berlin,de Bundesliga,27,1993,5,8,5,5,3,0,3,6,50.0,3,7,4,3,7,15,14,0
Dominique Heintz,de GER,DF,Freiburg,de Bundesliga,27,1993,0,0,0,0,0,0,0,0,,0,0,0,0,1,1,0,0
Jordan Henderson,eng ENG,MF,Liverpool,eng Premier League,31,1990,29,36,20,9,25,2,17,44,38.6,27,25,1,24,23,59,14,0
Liam Henderson,sct SCO,MF,Empoli,it Serie A,25,1996,22,22,13,7,8,7,9,31,29.0,22,14,4,10,9,31,13,0
Jeff Hendrick,ie IRL,MF,Newcastle Utd,eng Premier League,29,1992,1,1,1,0,1,0,1,1,100.0,0,0,0,0,0,1,1,0
Wayne Hennessey,wls WAL,GK,Burnley,eng Premier League,34,1987,2,0,0,0,0,0,0,0,,0,0,0,0,1,1,0,1
Benjamin Henrichs,de GER,DF,RB Leipzig,de Bundesliga,24,1997,13,30,21,18,6,6,12,22,54.5,10,16,1,15,19,49,14,0
Henrique,br BRA,DF,Lyon,fr Ligue 1,27,1994,12,13,7,10,1,2,5,16,31.3,11,13,1,12,22,35,14,0
Dalbert Henrique,br BRA,DFMF,Cagliari,it Serie A,27,1993,23,43,23,23,16,4,11,35,31.4,24,28,5,23,24,67,34,0
Luis Henrique,br BRA,FWMF,Marseille,fr Ligue 1,19,2001,8,4,3,2,1,1,2,5,40.0,3,2,0,2,5,9,1,0
Matheus Henrique,br BRA,MF,Sassuolo,it Serie A,23,1997,12,10,3,6,3,1,6,24,25.0,18,14,2,12,7,17,12,1
Rico Henry,eng ENG,DF,Brentford,eng Premier League,24,1997,31,28,20,18,8,2,12,34,35.3,22,31,10,21,26,54,76,1
Thomas Henry,fr FRA,FW,Venezia,it Serie A,26,1994,24,9,4,2,3,4,5,13,38.5,8,11,5,6,2,11,25,0
Christophe Hérelle,mq MTQ,DF,Brest,fr Ligue 1,28,1992,22,48,28,30,16,2,17,26,65.4,9,20,15,5,44,92,84,1
Jérôme Hergault,fr FRA,DF,Lorient,fr Ligue 1,35,1986,4,3,1,1,2,0,2,5,40.0,3,4,1,3,4,7,7,0
Kike Hermoso,es ESP,DF,Betis,es La Liga,21,1999,1,2,1,2,0,0,2,2,100.0,0,2,1,1,0,2,5,1
Mario Hermoso,es ESP,DF,Atlético Madrid,es La Liga,26,1995,21,30,15,23,4,3,20,38,52.6,18,18,3,15,29,59,49,2
Aridane Hernández,gq EQG,DF,Osasuna,es La Liga,32,1989,13,12,9,10,2,0,3,13,23.1,10,11,9,2,20,32,71,0
Lucas Hernández,fr FRA,DF,Bayern Munich,de Bundesliga,25,1996,23,50,31,20,24,6,26,42,61.9,16,22,11,11,28,78,54,1
Luis Hernández,es ESP,DF,Cádiz,es La Liga,32,1989,15,9,5,9,0,0,5,8,62.5,3,5,3,2,16,25,34,0
Mario Hernández,es ESP,DFFW,Rayo Vallecano,es La Liga,22,1999,4,10,4,7,3,0,5,9,55.6,4,1,0,1,4,14,7,0
Theo Hernández,fr FRA,DF,Milan,it Serie A,23,1997,30,53,35,34,14,5,29,40,72.5,11,16,3,13,23,76,29,3
Hernani,br BRA,MFFW,Genoa,it Serie A,27,1994,8,20,10,8,9,3,13,32,40.6,19,17,4,13,13,33,5,1
Ander Herrera,es ESP,MF,Paris S-G,fr Ligue 1,31,1989,12,29,17,7,16,6,14,39,35.9,25,22,8,14,14,43,8,0
Héctor Herrera,mx MEX,MF,Atlético Madrid,es La Liga,31,1990,10,16,8,11,4,1,7,20,35.0,13,13,2,11,12,28,16,0
Sergio Herrera,es ESP,GK,Osasuna,es La Liga,28,1993,36,3,2,3,0,0,3,6,50.0,3,1,0,1,1,4,18,0
Yangel Herrera,ve VEN,MF,Espanyol,es La Liga,23,1998,18,41,31,19,19,3,18,39,46.2,21,27,5,22,19,60,33,1
Patrick Herrmann,de GER,DFFW,M'Gladbach,de Bundesliga,30,1991,8,15,7,5,6,4,9,24,37.5,15,10,1,9,6,21,8,0
Son Heung-min,kr KOR,MFFW,Tottenham,eng Premier League,29,1992,33,15,6,5,7,3,5,23,21.7,18,27,6,21,13,28,8,0
Daan Heymans,be BEL,MFFW,Venezia,it Serie A,22,1999,3,3,1,1,2,0,1,5,20.0,4,7,3,4,4,7,3,0
Aaron Hickey,sct SCO,DF,Bologna,it Serie A,19,2002,31,46,29,24,15,7,20,30,66.7,10,36,13,23,29,75,44,0
Piero Hincapié,ec ECU,DF,Leverkusen,de Bundesliga,19,2002,20,33,23,23,8,2,19,25,76.0,6,34,15,19,33,66,56,2
Martin Hinteregger,at AUT,DF,Eint Frankfurt,de Bundesliga,28,1992,25,45,28,28,16,1,28,43,65.1,15,36,16,20,42,87,78,3
Marwin Hitz,ch SUI,GK,Dortmund,de Bundesliga,33,1987,5,0,0,0,0,0,0,0,,0,0,0,0,0,0,2,0
Ki-Jana Hoever,nl NED,DFMF,Wolves,eng Premier League,19,2002,3,10,6,5,5,0,7,12,58.3,5,6,0,6,6,16,8,0
Nicolas Höfler,de GER,MF,Freiburg,de Bundesliga,31,1990,29,73,42,37,29,7,28,62,45.2,34,50,21,29,46,119,42,0
Jonas Hofmann,de GER,MFFW,M'Gladbach,de Bundesliga,29,1992,23,30,20,6,17,7,17,42,40.5,25,23,0,23,12,42,10,0
Rob Holding,eng ENG,DF,Arsenal,eng Premier League,25,1995,9,13,9,11,1,1,5,6,83.3,1,23,18,5,10,23,42,1
Lucas Höler,de GER,FW,Freiburg,de Bundesliga,27,1994,29,41,25,10,17,14,13,28,46.4,15,25,4,21,17,58,39,2
Mason Holgate,eng ENG,DF,Everton,eng Premier League,24,1996,24,35,18,26,9,0,11,26,42.3,15,25,17,8,26,61,95,1
Gerrit Holtmann,ph PHI,FWMF,Bochum,de Bundesliga,26,1995,20,15,9,5,3,7,6,23,26.1,17,28,2,26,8,23,7,0
Martin Hongla,cm CMR,MF,Hellas Verona,it Serie A,23,1998,7,14,8,5,6,3,4,8,50.0,4,6,2,4,4,18,16,1
Franck Honorat,fr FRA,FWMF,Brest,fr Ligue 1,24,1996,32,54,38,25,13,16,27,48,56.3,21,24,2,22,15,69,25,0
Justin Hoogma,nl NED,DF,Greuther Fürth,de Bundesliga,23,1998,3,6,5,4,2,0,4,6,66.7,2,5,5,0,4,10,4,0
Sydney van Hooijdonk,nl NED,FWMF,Bologna,it Serie A,21,2000,0,0,0,0,0,0,0,1,0.0,1,1,0,1,0,0,0,0
Matthew Hoppe,us USA,FWMF,Mallorca,es La Liga,20,2001,2,1,0,0,0,1,0,3,0.0,3,0,0,0,0,1,0,0
Jannes Horn,de GER,DF,Köln,de Bundesliga,24,1997,5,6,4,4,2,0,4,8,50.0,4,1,1,0,3,9,9,0
Timo Horn,de GER,GK,Köln,de Bundesliga,28,1993,13,0,0,0,0,0,0,1,0.0,1,0,0,0,0,0,5,0
Fraser Hornby,sct SCO,FWMF,Reims,fr Ligue 1,21,1999,4,3,1,1,2,0,0,2,0.0,2,3,0,3,4,7,5,0
Cédric Hountondji,bj BEN,DF,Clermont Foot,fr Ligue 1,27,1994,23,33,17,20,12,1,16,24,66.7,8,23,12,11,34,67,76,0
Lukáš Hrádecký,fi FIN,GK,Leverkusen,de Bundesliga,31,1989,32,1,1,1,0,0,1,1,100.0,0,0,0,0,0,1,10,1
Branimir Hrgota,se SWE,FW,Greuther Fürth,de Bundesliga,28,1993,31,46,29,10,31,5,21,72,29.2,51,27,1,26,11,57,3,1
Petko Hristov,bg BUL,DF,Spezia,it Serie A,22,1999,14,17,10,11,6,0,10,16,62.5,6,29,23,6,19,36,47,0
Ajdin Hrustic,au AUS,MF,Eint Frankfurt,de Bundesliga,25,1996,11,16,11,5,7,4,11,32,34.4,21,18,1,17,10,26,7,0
Timo Hübers,de GER,DF,Köln,de Bundesliga,25,1996,19,45,27,28,17,0,27,45,60.0,18,31,19,12,52,97,95,0
Benjamin Hübner,de GER,DF,Hoffenheim,de Bundesliga,32,1989,4,9,5,0,7,2,3,5,60.0,2,2,2,0,9,18,7,0
Callum Hudson-Odoi,eng ENG,MFFW,Chelsea,eng Premier League,20,2000,11,14,10,5,6,3,8,23,34.8,15,8,0,8,2,16,6,1
Will Hughes,eng ENG,MF,Crystal Palace,eng Premier League,26,1995,12,29,14,10,16,3,7,16,43.8,9,13,7,6,8,37,10,0
Mats Hummels,de GER,DF,Dortmund,de Bundesliga,32,1988,20,34,22,20,13,1,20,36,55.6,16,18,13,5,32,66,66,1
Elseid Hysaj,al ALB,DF,Lazio,it Serie A,27,1994,23,46,30,25,17,4,29,45,64.4,16,18,6,12,24,70,34,1
Suk Hyun-jun,kr KOR,FWMF,Troyes,fr Ligue 1,30,1991,2,0,0,0,0,0,0,0,,0,2,0,2,0,0,2,0
Pierre Højbjerg,dk DEN,MF,Tottenham,eng Premier League,25,1995,36,78,45,31,38,9,38,85,44.7,47,61,13,48,48,126,54,0
Iago,br BRA,DF,Augsburg,de Bundesliga,24,1997,24,49,29,25,19,5,15,34,44.1,19,28,6,22,27,76,62,0
Robert Ibáñez,es ESP,MFFW,Osasuna,es La Liga,28,1993,1,3,3,2,0,1,1,2,50.0,1,1,0,1,1,4,1,0
Roger Ibanez,br BRA,DF,Roma,it Serie A,22,1998,32,54,32,31,19,4,26,43,60.5,17,26,7,19,62,116,104,2
Vicente Iborra,es ESP,MF,Villarreal,es La Liga,33,1988,12,19,10,9,7,3,12,24,50.0,12,11,5,6,11,30,27,1
Zlatan Ibrahimović,se SWE,FW,Milan,it Serie A,39,1981,11,0,0,0,0,0,0,2,0.0,2,2,1,1,3,3,9,0
Mauro Icardi,ar ARG,FW,Paris S-G,fr Ligue 1,28,1993,11,5,3,1,3,1,3,7,42.9,4,3,0,3,5,10,12,0
Adam Idah,ie IRL,FWMF,Norwich City,eng Premier League,20,2001,7,9,6,2,5,2,2,3,66.7,1,4,2,2,3,12,7,0
Oussama Idrissi,ma MAR,MFFW,Sevilla,es La Liga,25,1996,1,1,0,0,1,0,0,1,0.0,1,1,0,1,1,2,1,0
Oussama Idrissi,ma MAR,MF,Cádiz,es La Liga,25,1996,10,8,4,3,4,1,4,15,26.7,11,8,0,8,3,11,5,0
Iglesias,es ESP,DF,Getafe,es La Liga,23,1998,8,19,10,11,8,0,7,17,41.2,10,8,2,6,10,29,28,0
Borja Iglesias,es ESP,FW,Betis,es La Liga,28,1993,18,6,4,1,2,3,0,8,0.0,8,11,1,10,4,10,7,0
Jonathan Iglesias,uy URU,MF,Clermont Foot,fr Ligue 1,32,1988,6,18,11,6,10,2,10,18,55.6,8,8,2,6,5,23,2,1
Juan Ignacio Ramírez,uy URU,FW,Saint-Étienne,fr Ligue 1,24,1997,1,2,1,0,1,1,0,0,,0,0,0,0,0,2,0,0
Igor,br BRA,DF,Fiorentina,it Serie A,23,1998,25,53,31,34,16,3,30,40,75.0,10,37,19,18,31,84,46,4
Kelechi Iheanacho,ng NGA,FW,Leicester City,eng Premier League,24,1996,14,10,7,2,5,3,3,14,21.4,11,19,0,19,4,14,10,0
Danylo Ihnatenko,ua UKR,MF,Bordeaux,fr Ligue 1,24,1997,8,17,9,7,8,2,10,24,41.7,14,9,2,7,6,23,17,1
Jonathan Ikone,fr FRA,FW,Fiorentina,it Serie A,23,1998,7,7,3,2,3,2,3,10,30.0,7,10,2,8,1,8,2,0
Jonathan Ikone,fr FRA,MFFW,Lille,fr Ligue 1,23,1998,12,11,3,6,4,1,4,11,36.4,7,13,1,12,5,16,4,0
Ivan Ilić,rs SRB,MF,Hellas Verona,it Serie A,20,2001,28,39,18,16,19,4,20,54,37.0,34,34,12,22,22,61,55,0
Josip Iličić,si SVN,MFFW,Atalanta,it Serie A,33,1988,9,7,7,3,2,2,4,17,23.5,13,6,1,5,3,10,1,0
Asier Illarramendi,es ESP,MF,Real Sociedad,es La Liga,31,1990,4,9,5,5,3,1,1,10,10.0,9,5,1,4,4,13,12,0
Stefan Ilsanker,at AUT,DFMF,Eint Frankfurt,de Bundesliga,32,1989,3,14,8,7,6,1,5,10,50.0,5,6,2,4,6,20,15,1
Ciro Immobile,it ITA,FW,Lazio,it Serie A,31,1990,30,10,5,4,4,2,1,15,6.7,14,7,1,6,3,13,16,0
Burak İnce,tr TUR,FW,Arminia,de Bundesliga,17,2004,2,1,1,1,0,0,1,2,50.0,1,1,0,1,0,1,0,0
Danny Ings,eng ENG,FW,Aston Villa,eng Premier League,29,1992,21,23,16,2,16,5,13,37,35.1,24,31,2,29,6,29,22,0
Marcus Ingvartsen,dk DEN,MF,Union Berlin,de Bundesliga,25,1996,1,0,0,0,0,0,0,2,0.0,2,0,0,0,2,2,1,0
Marcus Ingvartsen,dk DEN,FWMF,Mainz 05,de Bundesliga,25,1996,8,3,2,2,0,1,3,9,33.3,6,6,0,6,6,9,7,1
Bonke Innocent,ng NGA,MF,Lorient,fr Ligue 1,25,1996,10,27,16,10,16,1,11,26,42.3,15,11,3,8,16,43,14,0
Lorenzo Insigne,it ITA,FW,Napoli,it Serie A,30,1991,25,23,14,8,12,3,8,44,18.2,36,30,1,29,20,43,3,1
Nikita Iosifov,ru RUS,MF,Villarreal,es La Liga,20,2001,0,0,0,0,0,0,0,0,,0,0,0,0,0,0,0,0
Tim Iroegbunam,eng ENG,MF,Aston Villa,eng Premier League,18,2003,1,5,4,2,3,0,1,1,100.0,0,0,0,0,2,7,1,0
Alexander Isak,se SWE,FW,Real Sociedad,es La Liga,21,1999,24,7,4,1,3,3,2,12,16.7,10,14,2,12,3,10,10,0
Isco,es ESP,MFFW,Real Madrid,es La Liga,29,1992,4,9,5,4,4,1,5,12,41.7,7,1,0,1,2,11,1,0
Wilson Isidor,fr FRA,FWMF,Monaco,fr Ligue 1,20,2000,1,0,0,0,0,0,0,4,0.0,4,1,0,1,0,0,0,0
Ardian Ismajli,al ALB,DF,Empoli,it Serie A,24,1996,14,13,9,8,4,1,5,14,35.7,9,21,11,10,24,37,80,0
Hiroki Ito,jp JPN,DF,Stuttgart,de Bundesliga,22,1999,26,43,31,21,19,3,25,43,58.1,18,40,19,21,53,96,95,0
Cedric Itten,ch SUI,FW,Greuther Fürth,de Bundesliga,24,1996,7,5,2,1,2,2,1,6,16.7,5,3,0,3,2,7,4,0
Gian-Luca Itter,de GER,DF,Greuther Fürth,de Bundesliga,22,1999,16,44,26,30,11,3,21,38,55.3,17,24,9,15,13,57,51,0
Alex Iwobi,ng NGA,MFDF,Everton,eng Premier League,25,1996,23,40,19,23,12,5,21,52,40.4,31,39,3,36,20,60,25,2
Armando Izzo,it ITA,DF,Torino,it Serie A,29,1992,6,16,9,14,2,0,9,11,81.8,2,5,4,1,17,33,21,0
Nicolas Jackson,sn SEN,FWMF,Villarreal,es La Liga,20,2001,2,2,0,1,0,1,0,0,,0,0,0,0,1,3,1,0
Lee Jae-sung,kr KOR,MFFW,Mainz 05,de Bundesliga,28,1992,16,30,12,8,14,8,6,27,22.2,21,20,2,18,18,48,18,0
Paul Jaeckel,de GER,DF,Union Berlin,de Bundesliga,23,1998,23,51,29,27,24,0,29,51,56.9,22,34,10,24,57,108,81,0
Mato Jajalo,ba BIH,MF,Udinese,it Serie A,33,1988,7,24,14,14,7,3,11,23,47.8,12,7,0,7,11,35,5,0
Kristijan Jakić,hr CRO,MF,Eint Frankfurt,de Bundesliga,24,1997,21,37,22,10,21,6,15,62,24.2,47,33,3,30,21,58,25,1
Ismail Jakobs,sn SEN,DFFW,Monaco,fr Ligue 1,21,1999,13,32,16,14,15,3,16,35,45.7,19,16,1,15,17,49,31,0
Marin Jakoliš,hr CRO,FW,Angers,fr Ligue 1,24,1996,3,2,1,0,1,1,0,6,0.0,6,0,0,0,1,3,0,0
Abdel Jalil Medioub,dz ALG,DF,Bordeaux,fr Ligue 1,23,1997,7,9,5,5,3,1,3,4,75.0,1,8,4,4,12,21,34,0
Daniel James,wls WAL,FW,Manchester Utd,eng Premier League,23,1997,1,2,1,0,2,0,0,0,,0,2,0,2,0,2,1,0
Daniel James,wls WAL,FWMF,Leeds United,eng Premier League,23,1997,26,24,14,8,8,8,10,23,43.5,13,18,1,17,8,32,12,0
Reece James,eng ENG,DF,Chelsea,eng Premier League,21,1999,21,33,25,14,18,1,9,22,40.9,13,20,2,18,17,50,22,0
Vitaly Janelt,de GER,MF,Brentford,eng Premier League,23,1998,26,61,32,26,27,8,27,53,50.9,26,23,7,16,28,89,35,0
Jakub Jankto,cz CZE,DFMF,Getafe,es La Liga,25,1996,7,11,7,5,5,1,10,17,58.8,7,4,0,4,4,15,7,0
Pontus Jansson,se SWE,DF,Brentford,eng Premier League,30,1991,37,40,21,32,8,0,22,34,64.7,12,37,27,10,52,92,187,0
Tony Jantschke,de GER,DF,M'Gladbach,de Bundesliga,31,1990,3,6,5,2,4,0,3,6,50.0,3,3,2,1,5,11,8,0
Adnan Januzaj,be BEL,FWMF,Real Sociedad,es La Liga,26,1995,18,17,11,5,8,4,9,24,37.5,15,15,3,12,12,29,15,0
Paweł Jaroszyński,pl POL,DF,Salernitana,it Serie A,26,1994,6,10,5,7,3,0,5,7,71.4,2,4,0,4,10,20,19,0
Jason,es ESP,MFFW,Alavés,es La Liga,27,1994,8,11,7,6,4,1,7,20,35.0,13,7,0,7,7,18,5,0
Jason,es ESP,MFDF,Valencia,es La Liga,27,1994,1,4,1,2,1,1,0,1,0.0,1,2,0,2,1,5,1,0
Dennis Jastrzembski,pl POL,DFFW,Hertha BSC,de Bundesliga,21,2000,3,2,1,1,1,0,2,8,25.0,6,1,0,1,5,7,3,0
Luis Javier Suárez,co COL,FW,Granada,es La Liga,23,1997,32,26,14,9,9,8,8,27,29.6,19,25,3,22,6,32,23,0
Corentin Jean,fr FRA,FWMF,Lens,fr Ligue 1,26,1995,3,9,6,4,4,1,3,6,50.0,3,5,0,5,1,10,0,0
Jemerson,br BRA,DF,Metz,fr Ligue 1,28,1992,13,37,25,30,7,0,18,26,69.2,8,23,8,15,25,62,33,1
Fredrik Jensen,fi FIN,MFFW,Augsburg,de Bundesliga,23,1997,5,5,4,1,3,1,4,7,57.1,3,5,1,4,2,7,4,0
Mathias Jensen,dk DEN,MF,Brentford,eng Premier League,25,1996,18,33,18,12,16,5,22,63,34.9,41,32,3,29,22,55,13,0
Moritz Jenz,de GER,DF,Lorient,fr Ligue 1,22,1999,15,26,12,18,6,2,11,24,45.8,13,19,11,8,28,54,55,0
Gabriel Jesus,br BRA,FW,Manchester City,eng Premier League,24,1997,21,18,12,2,4,12,6,26,23.1,20,18,0,18,15,33,8,0
Juan Jesus,br BRA,DF,Napoli,it Serie A,30,1991,14,25,17,14,11,0,12,18,66.7,6,21,16,5,9,34,34,0
Álvaro Jiménez,es ESP,MFFW,Cádiz,es La Liga,26,1995,3,6,3,3,2,1,4,7,57.1,3,3,0,3,3,9,0,0
Raúl Jiménez,mx MEX,FW,Wolves,eng Premier League,30,1991,29,29,14,6,16,7,6,30,20.0,24,31,5,26,13,42,26,0
João Pedro,br BRA,FWMF,Watford,eng Premier League,19,2001,18,20,14,7,8,5,6,23,26.1,17,23,3,20,15,35,17,0
Joaquín,es ESP,FWMF,Betis,es La Liga,40,1981,5,6,2,4,2,0,3,8,37.5,5,5,2,3,3,9,10,0
Joelinton,br BRA,MFFW,Newcastle Utd,eng Premier League,24,1996,28,72,38,30,33,9,26,61,42.6,35,47,11,36,34,106,50,2
Jofre,es ESP,MFDF,Espanyol,es La Liga,20,2001,0,1,1,0,0,1,1,1,100.0,0,0,0,0,0,1,0,0
Marco John,de GER,DF,Hoffenheim,de Bundesliga,19,2002,1,0,0,0,0,0,0,1,0.0,1,1,0,1,1,1,1,0
Dennis Johnsen,no NOR,FWMF,Venezia,it Serie A,23,1998,16,14,10,8,4,2,6,18,33.3,12,14,1,13,5,19,3,0
Ben Johnson,eng ENG,DF,West Ham,eng Premier League,21,2000,16,33,16,15,15,3,21,28,75.0,7,16,8,8,22,55,55,0
Curtis Jones,eng ENG,MF,Liverpool,eng Premier League,20,2001,10,11,9,3,6,2,1,10,10.0,9,4,0,4,6,17,4,0
Phil Jones,eng ENG,DF,Manchester Utd,eng Premier League,29,1992,2,5,5,3,1,1,2,3,66.7,1,4,4,0,3,8,8,0
Frenkie de Jong,nl NED,MF,Barcelona,es La Liga,24,1997,28,35,19,12,18,5,12,23,52.2,11,19,5,14,20,55,16,0
Luuk de Jong,nl NED,FW,Barcelona,es La Liga,30,1990,7,9,7,1,5,3,1,2,50.0,1,4,0,4,0,9,12,0
Joan Jordán,es ESP,MF,Sevilla,es La Liga,27,1994,28,61,30,22,31,8,28,65,43.1,37,27,6,21,30,91,18,1
Kaio Jorge,br BRA,MFFW,Juventus,it Serie A,19,2002,1,2,1,0,2,0,1,3,33.3,2,1,0,1,0,2,2,0
Jorginho,it ITA,MF,Chelsea,eng Premier League,29,1991,25,64,33,27,31,6,29,83,34.9,54,27,4,23,36,100,21,1
Josan,es ESP,DFMF,Elche,es La Liga,31,1989,14,36,22,23,9,4,26,44,59.1,18,11,4,7,10,46,21,0
Willian José,br BRA,FW,Betis,es La Liga,29,1991,18,15,13,2,10,3,2,8,25.0,6,10,2,8,3,18,16,0
Joselu,es ESP,FW,Alavés,es La Liga,31,1990,35,16,11,1,9,6,7,25,28.0,18,21,4,17,7,23,45,0
Josema,es ESP,DF,Elche,es La Liga,25,1996,2,3,2,1,1,1,0,2,0.0,2,1,1,0,0,3,11,0
Lenny Joseph,fr FRA,FWMF,Metz,fr Ligue 1,20,2000,2,2,1,1,1,0,0,0,,0,3,0,3,0,2,0,0
Diogo Jota,pt POR,FW,Liverpool,eng Premier League,24,1996,26,39,18,12,18,9,13,55,23.6,42,19,2,17,6,45,6,0
Stevan Jovetić,me MNE,FWMF,Hertha BSC,de Bundesliga,31,1989,11,5,2,0,2,3,1,6,16.7,5,3,0,3,1,6,6,0
Luka Jović,rs SRB,FW,Real Madrid,es La Liga,23,1997,4,1,1,0,1,0,0,1,0.0,1,3,0,3,1,2,4,0
Miguel Juan Llambrich,es ESP,DF,Espanyol,es La Liga,25,1996,1,2,2,1,1,0,0,0,,0,1,0,1,0,2,5,0
José Juan Macías,mx MEX,FWMF,Getafe,es La Liga,21,1999,2,1,0,0,0,1,0,1,0.0,1,1,0,1,1,2,0,0
Juanmi,es ESP,FW,Betis,es La Liga,28,1993,24,39,25,11,19,9,19,49,38.8,30,24,1,23,9,48,10,1
Gideon Jung,de GER,DF,Greuther Fürth,de Bundesliga,26,1994,2,3,1,1,2,0,2,4,50.0,2,1,1,0,2,5,5,0
Flavio Junior Bianchi,it ITA,FWMF,Genoa,it Serie A,21,2000,4,2,2,1,0,1,0,2,0.0,2,0,0,0,0,2,0,0
Lago Junior,ci CIV,FWMF,Mallorca,es La Liga,30,1990,2,3,2,3,0,0,3,5,60.0,2,0,0,0,2,5,2,0
Hamed Junior Traorè,ci CIV,FWMF,Sassuolo,it Serie A,21,2000,20,32,18,8,14,10,10,46,21.7,36,22,2,20,12,44,6,1
Vinicius Júnior,br BRA,FW,Real Madrid,es La Liga,21,2000,30,46,24,23,19,4,15,50,30.0,35,25,0,25,6,52,6,0
James Justin,eng ENG,DF,Leicester City,eng Premier League,23,1998,11,22,13,11,8,3,7,15,46.7,8,16,4,12,17,39,34,0
Jutglà,es ESP,FW,Barcelona,es La Liga,22,1999,3,2,1,0,1,1,0,1,0.0,1,2,0,2,1,3,1,0
Jens Jønsson,dk DEN,MF,Cádiz,es La Liga,28,1993,15,40,29,22,17,1,17,35,48.6,18,17,7,10,34,74,32,0
Mathias Jørgensen,dk DEN,DF,Brentford,eng Premier League,31,1990,6,10,4,3,5,2,7,10,70.0,3,6,1,5,10,20,13,0
Ozan Kabak,tr TUR,DF,Norwich City,eng Premier League,21,2000,10,10,5,4,6,0,5,9,55.6,4,19,11,8,16,26,26,0
Christian Kabasele,be BEL,DF,Watford,eng Premier League,30,1991,13,11,5,10,1,0,7,10,70.0,3,20,16,4,14,25,67,1
Issa Kaboré,bf BFA,DF,Troyes,fr Ligue 1,20,2001,25,45,22,22,14,9,20,38,52.6,18,27,2,25,20,65,38,1
Anton Kade,de GER,FWMF,Hertha BSC,de Bundesliga,17,2004,1,4,2,3,1,0,2,8,25.0,6,3,0,3,3,7,1,0
Pavel Kadeřábek,cz CZE,DFMF,Hoffenheim,de Bundesliga,29,1992,13,11,10,6,3,2,5,16,31.3,11,18,6,12,13,24,22,0
Tino Kadewere,zw ZIM,FW,Lyon,fr Ligue 1,25,1996,6,7,5,2,2,3,4,13,30.8,9,7,0,7,4,11,1,1
Florian Kainz,at AUT,MFFW,Köln,de Bundesliga,28,1992,26,41,26,9,25,7,23,51,45.1,28,27,3,24,32,73,24,0
Gaël Kakuta,cd COD,MFFW,Lens,fr Ligue 1,30,1991,19,22,14,2,13,7,4,20,20.0,16,10,0,10,4,26,3,0
Sasa Kalajdzic,at AUT,FW,Stuttgart,de Bundesliga,24,1997,14,10,6,2,5,3,3,11,27.3,8,5,0,5,2,12,14,0
Arnaud Kalimuendo,fr FRA,FW,Paris S-G,fr Ligue 1,19,2002,0,0,0,0,0,0,0,0,,0,0,0,0,0,0,0,0
Arnaud Kalimuendo,fr FRA,FW,Lens,fr Ligue 1,19,2002,24,9,8,1,3,5,2,7,28.6,5,6,1,5,8,17,0,0
Nikola Kalinić,hr CRO,FW,Hellas Verona,it Serie A,33,1988,5,2,0,0,1,1,1,2,50.0,1,2,0,2,0,2,2,0
Yayah Kallon,sl SLE,FWMF,Genoa,it Serie A,20,2001,7,15,11,5,6,4,3,11,27.3,8,7,1,6,1,16,5,0
Felix Kalu Nmecha,de GER,MFFW,Wolfsburg,de Bundesliga,20,2000,4,3,1,1,1,1,0,2,0.0,2,2,0,2,7,10,6,0
Samuel Kalu,ng NGA,FW,Watford,eng Premier League,23,1997,3,2,2,0,2,0,1,1,100.0,0,2,0,2,3,5,3,0
Samuel Kalu,ng NGA,FWMF,Bordeaux,fr Ligue 1,23,1997,4,8,5,3,4,1,2,5,40.0,3,2,0,2,3,11,1,0
Pierre Kalulu,fr FRA,DF,Milan,it Serie A,21,2000,22,61,36,36,21,4,17,22,77.3,5,36,15,21,26,87,54,0
Daichi Kamada,jp JPN,MF,Eint Frankfurt,de Bundesliga,24,1996,24,40,21,7,26,7,11,40,27.5,29,18,0,18,8,48,10,0
Boubacar Kamara,fr FRA,MFDF,Marseille,fr Ligue 1,21,1999,31,68,38,27,36,5,26,47,55.3,21,29,10,19,46,114,44,1
Hassane Kamara,ci CIV,DF,Watford,eng Premier League,27,1994,18,53,34,31,16,6,27,43,62.8,16,20,4,16,69,122,67,0
Hassane Kamara,ci CIV,MFDF,Nice,fr Ligue 1,27,1994,6,13,10,4,6,3,5,8,62.5,3,10,2,8,9,22,4,0
Dimitrije Kamenović,rs SRB,DF,Lazio,it Serie A,21,2000,1,1,1,1,0,0,1,1,100.0,0,0,0,0,2,3,1,0
Kevin Kampl,si SVN,MF,RB Leipzig,de Bundesliga,30,1990,21,41,19,16,20,5,10,42,23.8,32,24,5,19,24,65,17,0
Jean-Armel Kana-Biyik,cm CMR,DF,Metz,fr Ligue 1,32,1989,7,10,6,8,2,0,4,9,44.4,5,11,4,7,16,26,22,1
Nordine Kandil,fr FRA,MFFW,Strasbourg,fr Ligue 1,19,2001,1,2,1,2,0,0,1,1,100.0,0,1,1,0,0,2,0,0
Harry Kane,eng ENG,FW,Tottenham,eng Premier League,28,1993,36,15,5,2,10,3,7,18,38.9,11,26,8,18,3,18,39,0
Lee Kangin,kr KOR,MFFW,Mallorca,es La Liga,20,2001,16,13,6,2,9,2,5,29,17.2,24,11,1,10,5,18,7,0
N'Golo Kanté,fr FRA,MF,Chelsea,eng Premier League,30,1991,20,59,31,20,27,12,25,40,62.5,15,37,2,35,31,90,8,0
Stefanos Kapino,gr GRE,GK,Arminia,de Bundesliga,27,1994,1,0,0,0,0,0,0,0,,0,0,0,0,0,0,0,0
Atakan Karazor,de GER,MF,Stuttgart,de Bundesliga,24,1996,21,48,24,18,27,3,18,36,50.0,18,37,14,23,34,82,47,0
Rick Karsdorp,nl NED,DFFW,Roma,it Serie A,26,1995,32,53,38,33,13,7,28,50,56.0,22,22,5,17,34,87,26,1
Denso Kasius,nl NED,DFFW,Bologna,it Serie A,18,2002,2,8,6,4,3,1,2,5,40.0,3,4,0,4,3,11,4,0
Grigoris Kastanos,cy CYP,MFFW,Salernitana,it Serie A,23,1998,15,30,19,9,19,2,7,23,30.4,16,21,5,16,22,52,8,0
Silas Katompa,cd COD,FWMF,Stuttgart,de Bundesliga,22,1998,3,5,4,4,0,1,3,7,42.9,4,5,0,5,2,7,1,0
Noah Katterbach,de GER,DF,Köln,de Bundesliga,20,2001,0,1,1,1,0,0,1,1,100.0,0,0,0,0,0,1,1,0
Eiji Kawashima,jp JPN,GK,Strasbourg,fr Ligue 1,38,1983,1,0,0,0,0,0,0,0,,0,0,0,0,0,0,0,0
Edo Kayembe,cd COD,MF,Watford,eng Premier League,23,1998,9,21,13,11,9,1,8,16,50.0,8,6,1,5,9,30,13,0
Moise Kean,it ITA,FW,Everton,eng Premier League,21,2000,0,0,0,0,0,0,0,0,,0,0,0,0,0,0,0,0
Moise Kean,it ITA,FW,Juventus,it Serie A,21,2000,12,9,4,2,5,2,6,16,37.5,10,5,0,5,3,12,8,1
Michael Keane,eng ENG,DF,Everton,eng Premier League,28,1993,31,46,25,32,13,1,28,45,62.2,17,33,28,5,62,108,128,2
Ilan Kebbal,dz ALG,MFFW,Reims,fr Ligue 1,23,1998,20,31,15,13,10,8,12,44,27.3,32,16,0,16,13,44,3,0
Wajdi Kechrida,tn TUN,DFMF,Salernitana,it Serie A,25,1995,11,9,6,6,3,0,8,13,61.5,5,10,2,8,8,17,15,0
Thilo Kehrer,de GER,DF,Paris S-G,fr Ligue 1,24,1996,17,21,14,9,11,1,9,21,42.9,12,19,11,8,24,45,29,0
Habib Keita,ml MLI,MFFW,Lyon,fr Ligue 1,19,2002,0,0,0,0,0,0,0,0,,0,0,0,0,0,0,0,0
Naby Keïta,gn GUI,MF,Liverpool,eng Premier League,26,1995,13,46,23,17,19,10,26,42,61.9,16,33,2,31,14,60,8,0
Yannik Keitel,de GER,MF,Freiburg,de Bundesliga,21,2000,6,11,4,5,4,2,5,15,33.3,10,7,1,6,1,12,8,0
Caoimhín Kelleher,ie IRL,GK,Liverpool,eng Premier League,22,1998,2,1,1,1,0,0,1,1,100.0,0,0,0,0,0,1,1,0
Marc-Oliver Kempf,de GER,DF,Hertha BSC,de Bundesliga,26,1995,12,10,9,9,1,0,5,14,35.7,9,14,7,7,25,35,49,1
Marc-Oliver Kempf,de GER,DF,Stuttgart,de Bundesliga,26,1995,9,13,8,7,4,2,3,10,30.0,7,16,14,2,16,29,26,2
Kenedy,br BRA,DF,Chelsea,eng Premier League,25,1996,1,5,2,1,2,2,2,3,66.7,1,0,0,0,0,5,0,0
Jonjoe Kenny,eng ENG,DF,Everton,eng Premier League,24,1997,11,17,7,11,6,0,13,21,61.9,8,8,1,7,20,37,31,0
Dimitrios Keramitsis,gr GRE,MF,Roma,it Serie A,17,2004,0,0,0,0,0,0,0,0,,0,0,0,0,0,0,0,0
Franck Kessié,ci CIV,MF,Milan,it Serie A,24,1996,26,41,23,12,24,5,17,26,65.4,9,39,10,29,23,64,22,0
Saîf-Eddine Khaoui,tn TUN,MFFW,Clermont Foot,fr Ligue 1,26,1995,10,19,10,5,10,4,9,18,50.0,9,9,0,9,14,33,5,0
Wahbi Khazri,tn TUN,FWMF,Saint-Étienne,fr Ligue 1,30,1991,25,33,18,7,17,9,9,34,26.5,25,21,0,21,12,45,7,0
Rani Khedira,de GER,MF,Union Berlin,de Bundesliga,27,1994,31,75,38,25,42,8,32,66,48.5,34,21,8,13,50,125,27,1
Kike,es ESP,FW,Osasuna,es La Liga,31,1989,21,11,7,3,4,4,3,23,13.0,20,10,1,9,3,14,12,0
Luca Kilian,de GER,FW,Mainz 05,de Bundesliga,21,1999,0,0,0,0,0,0,0,0,,0,0,0,0,0,0,0,0
Luca Kilian,de GER,DF,Köln,de Bundesliga,21,1999,25,42,24,30,9,3,21,41,51.2,20,31,13,18,46,88,109,3
Max Kilman,eng ENG,DF,Wolves,eng Premier League,24,1997,30,50,26,38,10,2,24,37,64.9,13,36,21,15,45,95,113,3
Joshua Kimmich,de GER,MF,Bayern Munich,de Bundesliga,26,1995,28,39,20,14,17,8,18,58,31.0,40,34,8,26,52,91,29,1
Presnel Kimpembe,fr FRA,DF,Paris S-G,fr Ligue 1,25,1995,29,34,19,18,15,1,14,23,60.9,9,20,14,6,38,72,73,1
Joshua King,no NOR,FW,Watford,eng Premier League,29,1992,25,19,15,7,6,6,4,17,23.5,13,15,4,11,8,27,31,0
Jakub Kiwior,pl POL,MF,Spezia,it Serie A,21,2000,22,50,27,25,19,6,26,57,45.6,31,38,15,23,40,90,53,0
Sofian Kiyine,ma MAR,MFFW,Venezia,it Serie A,23,1997,14,24,14,9,11,4,12,32,37.5,20,15,1,14,10,34,9,0
Simon Kjær,dk DEN,DF,Milan,it Serie A,32,1989,9,20,12,9,8,3,6,12,50.0,6,17,13,4,9,29,39,0
Kristoffer Klaesson,no NOR,GK,Leeds United,eng Premier League,20,2000,0,0,0,0,0,0,0,0,,0,0,0,0,0,0,0,0
Philipp Klement,de GER,MF,Stuttgart,de Bundesliga,28,1992,4,7,3,1,4,2,3,3,100.0,0,6,1,5,1,8,0,0
Mateusz Klich,pl POL,MF,Leeds United,eng Premier League,31,1990,23,47,25,18,23,6,25,66,37.9,41,22,4,18,11,58,20,0
Thibault Klidje,tg TOG,MFFW,Bordeaux,fr Ligue 1,20,2001,1,0,0,0,0,0,0,1,0.0,1,1,1,0,2,2,0,0
Mateo Klimowicz,de GER,MFFW,Stuttgart,de Bundesliga,21,2000,7,13,6,6,7,0,5,16,31.3,11,2,0,2,4,17,3,0
Fabian Klos,de GER,FW,Arminia,de Bundesliga,33,1987,16,7,5,0,5,2,2,10,20.0,8,17,4,13,0,7,31,0
Lukas Klostermann,de GER,DF,RB Leipzig,de Bundesliga,25,1996,18,29,16,11,15,3,13,19,68.4,6,16,3,13,26,55,58,0
Justin Kluivert,nl NED,MF,Nice,fr Ligue 1,22,1999,21,19,9,6,12,1,5,21,23.8,16,13,1,12,14,33,6,0
Lukas Klünter,de GER,DF,Hertha BSC,de Bundesliga,25,1996,2,1,1,1,0,0,1,5,20.0,4,1,0,1,2,3,2,0
Ansgar Knauff,de GER,FWMF,Dortmund,de Bundesliga,19,2002,1,3,1,1,1,1,0,4,0.0,4,2,0,2,0,3,4,0
Ansgar Knauff,de GER,DFMF,Eint Frankfurt,de Bundesliga,19,2002,8,18,14,8,5,5,8,15,53.3,7,11,1,10,8,26,6,0
Robin Knoche,de GER,DF,Union Berlin,de Bundesliga,29,1992,33,50,24,38,12,0,30,53,56.6,23,45,26,19,49,99,151,1
Gregor Kobel,ch SUI,GK,Dortmund,de Bundesliga,23,1997,29,0,0,0,0,0,0,2,0.0,2,0,0,0,1,1,20,0
Robin Koch,de GER,MFDF,Leeds United,eng Premier League,25,1996,18,21,13,9,10,2,9,34,26.5,25,26,10,16,20,41,44,0
Samuel Koeberlé,fr FRA,FW,Reims,fr Ligue 1,16,2004,0,0,0,0,0,0,0,0,,0,0,0,0,0,0,0,0
Philippe Koffi,fr FRA,FW,Reims,fr Ligue 1,19,2002,4,4,0,0,3,1,0,2,0.0,2,2,1,1,3,7,3,0
Dominik Kohr,de GER,MF,Mainz 05,de Bundesliga,27,1994,18,40,20,18,19,3,16,42,38.1,26,21,2,19,35,75,22,0
Koba Koindredi,fr FRA,MF,Valencia,es La Liga,19,2001,2,4,3,2,1,1,2,6,33.3,4,3,0,3,4,8,5,0
Koke,es ESP,MF,Atlético Madrid,es La Liga,29,1992,28,55,30,19,29,7,26,63,41.3,37,21,5,16,24,79,31,1
Aleksandr Kokorin,ru RUS,FWMF,Fiorentina,it Serie A,30,1991,1,1,1,1,0,0,0,0,,0,1,0,1,0,1,0,0
Aleksandar Kolarov,rs SRB,DF,Inter,it Serie A,35,1985,1,1,1,1,0,0,1,1,100.0,0,0,0,0,1,2,2,0
Sead Kolašinac,ba BIH,DF,Arsenal,eng Premier League,28,1993,1,0,0,0,0,0,0,0,,0,0,0,0,4,4,1,0
Sead Kolašinac,ba BIH,DF,Marseille,fr Ligue 1,28,1993,5,7,6,2,3,2,5,8,62.5,3,4,0,4,0,7,7,1
Luca Koleosho,ca CAN,FW,Espanyol,es La Liga,16,2004,0,0,0,0,0,0,0,0,,0,0,0,0,0,0,0,0
Randal Kolo Muani,fr FRA,FWMF,Nantes,fr Ligue 1,22,1998,33,28,14,7,10,11,10,25,40.0,15,14,3,11,6,34,31,0
Timothée Kolodziejczak,fr FRA,DF,Saint-Étienne,fr Ligue 1,29,1991,29,43,24,22,14,7,20,36,55.6,16,29,7,22,60,103,72,1
Ghislain Konan,ci CIV,DF,Reims,fr Ligue 1,25,1995,27,35,19,19,15,1,16,30,53.3,14,35,8,27,28,63,45,0
Ibrahima Konaté,fr FRA,DF,Liverpool,eng Premier League,22,1999,11,16,10,9,6,1,7,10,70.0,3,13,9,4,16,32,37,1
Geoffrey Kondogbia,cf CTA,MFDF,Atlético Madrid,es La Liga,28,1993,21,74,44,25,40,9,21,49,42.9,28,16,5,11,44,118,24,0
Ibrahima Koné,ml MLI,FW,Lorient,fr Ligue 1,22,1999,8,7,4,0,3,4,2,3,66.7,1,8,3,5,1,8,3,0
Kouadio Koné,fr FRA,MF,M'Gladbach,de Bundesliga,20,2001,24,68,35,31,34,3,29,46,63.0,17,28,5,23,34,102,14,0
Youssouf Koné,ml MLI,DF,Troyes,fr Ligue 1,26,1995,11,30,18,21,8,1,19,30,63.3,11,8,3,5,10,40,25,0
Ezri Konsa,eng ENG,DF,Aston Villa,eng Premier League,23,1997,28,25,15,13,11,1,10,13,76.9,3,31,22,9,15,40,86,2
Teun Koopmeiners,nl NED,MF,Atalanta,it Serie A,23,1998,24,40,24,10,19,11,22,54,40.7,32,31,2,29,15,55,19,0
Laurent Koscielny,fr FRA,DF,Bordeaux,fr Ligue 1,35,1985,10,14,9,10,3,1,8,13,61.5,5,17,12,5,12,26,39,0
Odilon Kossonou,ci CIV,DF,Leverkusen,de Bundesliga,20,2001,20,23,17,16,6,1,15,25,60.0,10,36,14,22,26,49,66,0
Filip Kostić,rs SRB,DFFW,Eint Frankfurt,de Bundesliga,28,1992,28,44,17,26,9,9,20,53,37.7,33,24,1,23,15,59,24,0
Rominigue Kouamé,ml MLI,MF,Troyes,fr Ligue 1,24,1996,33,47,22,24,20,3,19,58,32.8,39,33,5,28,46,93,22,2
Kalidou Koulibaly,sn SEN,DF,Napoli,it Serie A,30,1991,27,39,23,31,6,2,25,38,65.8,13,41,25,16,29,68,90,1
Jules Koundé,fr FRA,DF,Sevilla,es La Liga,22,1998,30,40,17,27,10,3,18,28,64.3,10,33,18,15,21,61,101,2
Christos Kourfalidis,gr GRE,MFFW,Cagliari,it Serie A,18,2002,0,0,0,0,0,0,0,1,0.0,1,1,0,1,0,0,0,0
Boubakar Kouyaté,ml MLI,DF,Metz,fr Ligue 1,24,1997,30,84,50,56,28,0,48,77,62.3,29,63,33,30,79,163,217,3
Cheikhou Kouyaté,sn SEN,MF,Crystal Palace,eng Premier League,31,1989,22,52,38,28,22,2,18,39,46.2,21,40,14,26,38,90,39,0
Mateo Kovačić,hr CRO,MF,Chelsea,eng Premier League,27,1994,17,51,31,14,26,11,17,35,48.6,18,19,4,15,7,58,9,1
Viktor Kovalenko,ua UKR,MF,Spezia,it Serie A,25,1996,15,16,10,7,8,1,9,21,42.9,12,16,3,13,13,29,8,0
Emil Krafth,se SWE,DF,Newcastle Utd,eng Premier League,26,1994,18,37,16,25,11,1,27,36,75.0,9,16,10,6,25,62,56,0
Alex Král,cz CZE,MF,West Ham,eng Premier League,23,1998,0,0,0,0,0,0,0,0,,0,0,0,0,0,0,0,0
Andrej Kramarić,hr CRO,FWMF,Hoffenheim,de Bundesliga,30,1991,30,8,4,1,5,2,7,17,41.2,10,10,0,10,9,17,7,1
Christoph Kramer,de GER,MF,M'Gladbach,de Bundesliga,30,1991,8,28,11,15,10,3,12,28,42.9,16,18,5,13,12,40,9,0
Jean-Philippe Krasso,ci CIV,FW,Saint-Étienne,fr Ligue 1,24,1997,5,7,5,0,5,2,2,10,20.0,8,7,1,6,0,7,1,0
Julian Kristoffersen,no NOR,FW,Salernitana,it Serie A,24,1997,0,0,0,0,0,0,0,0,,0,0,0,0,0,0,0,0
Toni Kroos,de GER,MF,Real Madrid,es La Liga,31,1990,23,34,26,13,17,4,14,36,38.9,22,16,3,13,12,46,13,1
Florian Krüger,de GER,FWMF,Arminia,de Bundesliga,22,1999,13,3,1,0,3,0,2,10,20.0,8,12,1,11,2,5,13,0
Tim Krul,nl NED,GK,Norwich City,eng Premier League,33,1988,29,1,1,1,0,0,1,4,25.0,3,0,0,0,0,1,10,4
Rade Krunić,ba BIH,MFFW,Milan,it Serie A,27,1993,16,33,18,16,14,3,15,31,48.4,16,19,2,17,16,49,17,0
Max Kruse,de GER,MFFW,Wolfsburg,de Bundesliga,33,1988,13,9,3,4,4,1,5,12,41.7,7,2,0,2,3,12,4,0
Max Kruse,de GER,FWMF,Union Berlin,de Bundesliga,33,1988,14,4,1,0,3,1,2,16,12.5,14,12,0,12,3,7,2,0
Lukas Kübler,de GER,DFMF,Freiburg,de Bundesliga,28,1992,26,62,35,38,16,8,28,49,57.1,21,24,8,16,44,106,70,0
Takefusa Kubo,jp JPN,FWMF,Mallorca,es La Liga,20,2001,18,31,19,12,14,5,10,24,41.7,14,24,3,21,8,39,4,0
Juraj Kucka,sk SVK,MF,Watford,eng Premier League,34,1987,21,59,39,32,25,2,27,73,37.0,46,30,9,21,27,86,46,2
Mykola Kukharevych,ua UKR,FW,Troyes,fr Ligue 1,20,2001,0,0,0,0,0,0,0,0,,0,0,0,0,0,0,0,0
Dejan Kulusevski,se SWE,MFFW,Tottenham,eng Premier League,21,2000,14,19,13,7,10,2,5,23,21.7,18,14,0,14,13,32,3,0
Dejan Kulusevski,se SWE,FWMF,Juventus,it Serie A,21,2000,9,15,12,9,6,0,8,21,38.1,13,14,0,14,5,20,5,0
Marash Kumbulla,al ALB,DF,Roma,it Serie A,21,2000,11,21,13,13,7,1,8,15,53.3,7,17,8,9,16,37,26,0
Fabian Kunze,de GER,MF,Arminia,de Bundesliga,23,1998,14,35,21,14,20,1,15,32,46.9,17,17,2,15,19,54,27,1
Enock Kwateng,fr FRA,DF,Bordeaux,fr Ligue 1,24,1997,22,54,35,31,19,4,33,72,45.8,39,17,4,13,43,97,48,1
Grejohn Kyei,fr FRA,FW,Clermont Foot,fr Ligue 1,25,1995,4,3,2,1,1,1,0,6,0.0,6,6,0,6,0,3,1,0
Giorgos Kyriakopoulos,gr GRE,DFFW,Sassuolo,it Serie A,25,1996,22,30,14,19,7,4,19,38,50.0,19,32,9,23,11,41,52,0
Andrea La Mantia,it ITA,FWMF,Empoli,it Serie A,30,1991,5,2,0,0,0,2,1,2,50.0,1,3,1,2,1,3,6,0
Gaëtan Laborde,fr FRA,FW,Montpellier,fr Ligue 1,27,1994,4,2,2,1,1,0,2,4,50.0,2,3,0,3,5,7,5,0
Gaëtan Laborde,fr FRA,FW,Rennes,fr Ligue 1,27,1994,30,19,7,5,8,6,3,22,13.6,19,29,3,26,8,27,16,0
Alexandre Lacazette,fr FRA,FW,Arsenal,eng Premier League,30,1991,20,27,10,8,13,6,7,21,33.3,14,12,1,11,5,32,6,0
Tom Lacoux,fr FRA,DFMF,Bordeaux,fr Ligue 1,19,2002,10,18,13,11,5,2,9,24,37.5,15,14,4,10,9,27,20,1
Lenny Lacroix,fr FRA,DF,Metz,fr Ligue 1,18,2003,2,9,7,8,1,0,5,8,62.5,3,5,1,4,10,19,5,0
Maxence Lacroix,fr FRA,DF,Wolfsburg,de Bundesliga,21,2000,28,59,33,41,16,2,29,40,72.5,11,35,16,19,60,119,144,0
Alban Lafont,fr FRA,GK,Nantes,fr Ligue 1,22,1999,38,3,3,3,0,0,3,8,37.5,5,1,0,1,1,4,25,2
Víctor Laguardia,es ESP,DF,Alavés,es La Liga,31,1989,34,29,16,21,8,0,19,30,63.3,11,36,24,12,27,56,151,1
Konrad Laimer,at AUT,MF,RB Leipzig,de Bundesliga,24,1997,14,38,24,11,22,5,24,53,45.3,29,29,3,26,4,42,9,0
Stefan Lainer,at AUT,DF,M'Gladbach,de Bundesliga,28,1992,16,20,11,9,8,3,13,30,43.3,17,24,5,19,14,34,33,0
Diego Lainez,mx MEX,FW,Betis,es La Liga,21,2000,2,1,1,0,1,0,0,3,0.0,3,3,0,3,1,2,0,0
Adam Lallana,eng ENG,MF,Brighton,eng Premier League,33,1988,17,34,17,14,14,6,12,41,29.3,29,16,6,10,16,50,13,1
Vassilis Lambropoulos,gr GRE,DF,Bochum,de Bundesliga,31,1990,13,18,12,13,3,2,11,25,44.0,14,21,10,11,17,35,56,0
Érik Lamela,ar ARG,FWMF,Sevilla,es La Liga,29,1992,11,31,18,12,14,5,10,29,34.5,19,11,0,11,5,36,3,0
Mohamed Lamine Bayo,gn GUI,FW,Clermont Foot,fr Ligue 1,23,1998,27,12,5,4,3,5,3,24,12.5,21,7,1,6,7,19,14,0
Didier Lamkel Zé,cm CMR,FW,Metz,fr Ligue 1,24,1996,7,3,1,1,0,2,1,3,33.3,2,3,1,2,1,4,7,0
Sam Lammers,nl NED,FWMF,Atalanta,it Serie A,24,1997,0,1,0,0,0,1,0,0,,0,0,0,0,0,1,0,0
Sam Lammers,nl NED,FWMF,Eint Frankfurt,de Bundesliga,24,1997,6,4,4,0,2,2,2,6,33.3,4,9,2,7,2,6,4,0
Tariq Lamptey,gh GHA,DFFW,Brighton,eng Premier League,20,2000,17,36,25,14,17,5,15,25,60.0,10,13,3,10,21,57,23,0
Manuel Lanzini,ar ARG,MFFW,West Ham,eng Premier League,28,1993,20,28,15,10,11,7,10,35,28.6,25,16,0,16,19,47,10,0
Aymeric Laporte,es ESP,DF,Manchester City,eng Premier League,27,1994,31,33,15,22,10,1,14,20,70.0,6,15,10,5,20,53,64,2
Julien Laporte,fr FRA,DF,Lorient,fr Ligue 1,27,1993,32,63,45,35,26,2,32,64,50.0,32,37,22,15,54,117,174,0
Yasser Larouci,dz ALG,DF,Troyes,fr Ligue 1,20,2001,4,6,5,2,4,0,3,3,100.0,0,1,0,1,7,13,5,0
Kevin Lasagna,it ITA,MFFW,Hellas Verona,it Serie A,28,1992,13,13,7,4,5,4,4,15,26.7,11,16,0,16,3,16,7,0
Jamaal Lascelles,eng ENG,DF,Newcastle Utd,eng Premier League,27,1993,23,15,7,9,5,1,4,12,33.3,8,38,28,10,22,37,121,1
Bryan Lasme,fr FRA,FW,Arminia,de Bundesliga,22,1998,10,6,6,1,2,3,0,3,0.0,3,7,0,7,1,7,9,0
Paul Lasne,fr FRA,MF,Brest,fr Ligue 1,32,1989,9,26,12,6,16,4,8,19,42.1,11,11,2,9,24,50,10,0
Latasa,es ESP,FW,Real Madrid,es La Liga,20,2001,0,0,0,0,0,0,0,0,,0,0,0,0,0,0,0,0
Toni Lato,es ESP,DF,Valencia,es La Liga,23,1997,7,17,12,12,3,2,9,16,56.3,7,6,0,6,8,25,14,0
Armand Lauriente,fr FRA,FWMF,Lorient,fr Ligue 1,22,1998,28,33,18,9,16,8,11,30,36.7,19,27,2,25,15,48,3,0
Darko Lazović,rs SRB,DF,Hellas Verona,it Serie A,30,1990,31,36,23,20,8,8,21,39,53.8,18,28,4,24,19,55,49,1
Manuel Lazzari,it ITA,DF,Lazio,it Serie A,27,1993,19,28,14,13,15,0,16,26,61.5,10,10,2,8,12,40,16,1
Théo Le Bris,fr FRA,MF,Lorient,fr Ligue 1,18,2002,1,2,1,1,1,0,1,2,50.0,1,2,0,2,0,2,1,0
Jérémy Le Douaron,fr FRA,FWMF,Brest,fr Ligue 1,23,1998,16,11,5,4,4,3,1,17,5.9,16,15,0,15,4,15,14,0
Enzo Le Fée,fr FRA,MFFW,Lorient,fr Ligue 1,21,2000,24,70,44,25,36,9,41,90,45.6,49,25,1,24,29,99,18,0
Vincent Le Goff,fr FRA,DF,Lorient,fr Ligue 1,31,1989,34,61,38,38,19,4,37,62,59.7,25,18,3,15,37,98,50,0
Maxime Le Marchand,fr FRA,DF,Strasbourg,fr Ligue 1,31,1989,10,17,8,16,1,0,8,10,80.0,2,9,5,4,14,31,32,0
Robin Le Normand,fr FRA,DF,Real Sociedad,es La Liga,24,1996,37,49,32,36,8,5,28,36,77.8,8,34,22,12,48,97,125,0
Patrick Leal,us USA,FW,Venezia,it Serie A,18,2003,0,0,0,0,0,0,0,1,0.0,1,0,0,0,0,0,0,0
Rafael Leão,pt POR,FW,Milan,it Serie A,22,1999,29,17,7,3,9,5,10,20,50.0,10,12,1,11,12,29,8,0
Jean-Louis Leca,fr FRA,GK,Lens,fr Ligue 1,35,1985,26,0,0,0,0,0,0,0,,0,1,0,1,1,1,11,1
Jeremías Ledesma,ar ARG,GK,Cádiz,es La Liga,28,1993,38,3,1,3,0,0,3,4,75.0,1,0,0,0,1,4,21,4
Pierre Lees-Melou,fr FRA,MF,Norwich City,eng Premier League,28,1993,25,58,36,23,29,6,25,92,27.2,67,37,11,26,25,83,23,0
Wu Lei,cn CHN,FWMF,Espanyol,es La Liga,29,1991,5,3,2,1,2,0,3,8,37.5,5,4,0,4,4,7,3,0
Maxim Leitsch,de GER,DF,Bochum,de Bundesliga,23,1998,17,18,10,9,7,2,10,15,66.7,5,31,19,12,31,49,74,1
Lucas Leiva,br BRA,MF,Lazio,it Serie A,34,1987,19,55,30,26,25,4,15,53,28.3,38,27,10,17,28,83,37,0
Florian Lejeune,fr FRA,DF,Alavés,es La Liga,30,1991,30,33,24,22,10,1,12,20,60.0,8,30,19,11,31,64,158,0
Iñigo Lekue,es ESP,DF,Athletic Club,es La Liga,28,1993,21,32,23,16,12,4,22,44,50.0,22,37,12,25,23,55,63,0
Thomas Lemar,fr FRA,MF,Atlético Madrid,es La Liga,25,1995,16,24,14,9,12,3,8,23,34.8,15,18,0,18,8,32,11,0
Félix Lemaréchal,ci CIV,MF,Monaco,fr Ligue 1,17,2003,0,0,0,0,0,0,0,1,0.0,1,0,0,0,0,0,0,0
Mario Lemina,ga GAB,MF,Nice,fr Ligue 1,27,1993,22,62,35,25,33,4,28,38,73.7,10,32,9,23,48,110,37,0
Fabien Lemoine,fr FRA,MF,Lorient,fr Ligue 1,34,1987,12,35,22,20,14,1,17,41,41.5,24,21,4,17,14,49,24,1
Tim Lemperle,de GER,FWMF,Köln,de Bundesliga,19,2002,2,4,1,2,1,1,1,3,33.3,2,1,0,1,2,6,2,0
Ruben Lendinez,es ESP,DF,Valencia,es La Liga,18,2003,2,3,3,1,2,0,3,8,37.5,5,4,0,4,2,5,6,0
Clément Lenglet,fr FRA,DF,Barcelona,es La Liga,26,1995,9,20,11,11,7,2,8,13,61.5,5,7,3,4,13,33,21,0
Aaron Lennon,eng ENG,MFFW,Burnley,eng Premier League,34,1987,17,33,17,10,13,10,10,34,29.4,24,26,4,22,9,42,14,0
Bernd Leno,de GER,GK,Arsenal,eng Premier League,29,1992,4,1,1,1,0,0,1,1,100.0,0,0,0,0,0,1,1,0
Christopher Lenz,de GER,DF,Eint Frankfurt,de Bundesliga,26,1994,7,29,15,22,6,1,12,21,57.1,9,9,4,5,7,36,21,0
Léo Leroy,fr FRA,MF,Montpellier,fr Ligue 1,21,2000,7,31,21,17,11,3,12,34,35.3,22,20,4,16,8,39,8,0
Alexandre Letellier,fr FRA,GK,Paris S-G,fr Ligue 1,30,1990,0,0,0,0,0,0,0,0,,0,0,0,0,0,0,0,0
Robert Lewandowski,pl POL,FW,Bayern Munich,de Bundesliga,32,1988,33,10,3,0,6,4,5,17,29.4,12,17,2,15,6,16,8,0
Jamie Leweling,de GER,FWMF,Greuther Fürth,de Bundesliga,20,2001,22,13,8,3,7,3,3,16,18.8,13,9,0,9,13,26,5,0
Jamal Lewis,nir NIR,DF,Newcastle Utd,eng Premier League,23,1998,3,8,6,6,1,1,3,4,75.0,1,3,2,1,3,11,8,0
Luca Lezzerini,it ITA,GK,Venezia,it Serie A,26,1995,6,0,0,0,0,0,0,0,,0,1,0,1,0,0,0,0
Ben Lhassine Kone,ci CIV,MF,Torino,it Serie A,21,2000,1,3,3,1,2,0,1,2,50.0,1,0,0,0,1,4,1,0
Yanis Lhery,fr FRA,FWMF,Saint-Étienne,fr Ligue 1,18,2003,1,0,0,0,0,0,0,0,,0,4,0,4,0,0,0,0
Dimitri Liénard,fr FRA,DFMF,Strasbourg,fr Ligue 1,33,1988,23,71,43,40,21,10,46,77,59.7,31,12,0,12,21,92,28,0
Philipp Lienhart,at AUT,DF,Freiburg,de Bundesliga,25,1996,32,24,13,17,6,1,13,24,54.2,11,33,23,10,50,74,158,1
Matthijs de Ligt,nl NED,DF,Juventus,it Serie A,21,1999,30,34,19,21,13,0,15,18,83.3,3,31,21,10,26,60,103,0
Isaac Lihadji,fr FRA,MFFW,Lille,fr Ligue 1,19,2002,3,3,3,1,1,1,1,5,20.0,4,1,0,1,2,5,0,0
Anderson Lima,br BRA,MF,Lazio,it Serie A,21,1999,1,2,0,1,1,0,0,2,0.0,2,1,0,1,2,4,1,0
Andreas Linde,se SWE,GK,Greuther Fürth,de Bundesliga,28,1993,12,0,0,0,0,0,0,0,,0,0,0,0,1,1,1,1
Victor Lindelöf,se SWE,DF,Manchester Utd,eng Premier League,27,1994,26,16,11,9,7,0,9,14,64.3,5,26,17,9,25,41,96,0
Jesper Lindstrøm,dk DEN,MFFW,Eint Frankfurt,de Bundesliga,21,2000,22,28,13,6,13,9,12,36,33.3,24,30,0,30,24,52,11,1
Karol Linetty,pl POL,MFFW,Torino,it Serie A,26,1995,10,14,8,3,4,7,6,18,33.3,12,8,0,8,3,17,2,0
Jesse Lingard,eng ENG,FWMF,Manchester Utd,eng Premier League,28,1992,4,9,7,4,3,2,2,6,33.3,4,4,0,4,0,9,1,0
Pol Lirola,es ESP,DFFW,Marseille,fr Ligue 1,23,1997,20,28,16,15,9,4,13,28,46.4,15,15,0,15,13,41,22,0
Valentino Livramento,eng ENG,DF,Southampton,eng Premier League,18,2002,25,54,28,30,18,6,27,45,60.0,18,23,9,14,47,101,50,1
Dejan Ljubicic,at AUT,MFFW,Köln,de Bundesliga,23,1997,22,33,19,12,13,8,13,49,26.5,36,19,1,18,15,48,11,0
Javier Llabrés,,FWMF,Mallorca,es La Liga,,,1.5,2,1,0,1,1,1,2,50.0,1,1,0,1,0,2,0,0
Diego Llorente,es ESP,DF,Leeds United,eng Premier League,27,1993,26,53,31,32,19,2,33,47,70.2,14,35,17,18,40,93,77,2
Marcos Llorente,es ESP,MFDF,Atlético Madrid,es La Liga,26,1995,27.2,51,23,25,22,4,28,43,65.1,15,33,10,23,27,78,44,0
Hugo Lloris,fr FRA,GK,Tottenham,eng Premier League,34,1986,38,1,1,1,0,0,1,2,50.0,1,0,0,0,1,2,24,3
Giovani Lo Celso,ar ARG,MFFW,Tottenham,eng Premier League,25,1996,2.6,8,4,4,2,2,4,10,40.0,6,6,1,5,1,9,0,1
Giovani Lo Celso,ar ARG,FWMF,Villarreal,es La Liga,25,1996,11,22,12,8,10,4,9,22,40.9,13,4,0,4,5,27,3,0
Julen Lobete,es ESP,FWMF,Real Sociedad,es La Liga,20,2000,3.2,4,3,3,0,1,1,2,50.0,1,6,1,5,1,5,1,0
Stanislav Lobotka,sk SVK,MF,Napoli,it Serie A,26,1994,18.7,39,24,16,20,3,14,36,38.9,22,9,1,8,12,51,13,1
Jürgen Locadia,nl NED,MFFW,Brighton,eng Premier League,27,1993,0.3,0,0,0,0,0,0,0,,0,0,0,0,0,0,0,0
Jürgen Locadia,nl NED,FWMF,Bochum,de Bundesliga,27,1993,4.9,4,2,1,0,3,1,1,100.0,0,1,0,1,1,5,2,0
Manuel Locatelli,it ITA,MF,Juventus,it Serie A,23,1998,24,44,25,21,16,7,21,47,44.7,26,43,21,22,22,66,33,0
Banzouzi Locko,fr FRA,MFDF,Reims,fr Ligue 1,19,2002,11.2,28,19,13,11,4,14,24,58.3,10,20,8,12,14,42,15,0
Renan Lodi,br BRA,DF,Atlético Madrid,es La Liga,23,1998,13.1,31,18,14,13,4,11,27,40.7,16,22,4,18,13,44,19,1
Ruben Loftus-Cheek,eng ENG,MFDF,Chelsea,eng Premier League,25,1996,15.5,29,10,16,11,2,10,19,52.6,9,15,6,9,11,40,17,0
Kevin Long,ie IRL,DF,Burnley,eng Premier League,30,1990,4.6,3,2,1,2,0,1,2,50.0,1,4,1,3,1,4,20,0
Shane Long,ie IRL,FW,Southampton,eng Premier League,34,1987,3.4,9,5,2,4,3,1,1,100.0,0,4,0,4,0,9,2,0
Sean Longstaff,eng ENG,MF,Newcastle Utd,eng Premier League,23,1997,16.3,54,34,18,31,5,24,65,36.9,41,18,6,12,9,63,18,0
Ademola Lookman,ng NGA,FWMF,Leicester City,eng Premier League,23,1997,16.1,32,14,10,13,9,10,28,35.7,18,19,1,18,10,42,4,0
Anthony Lopes,pt POR,GK,Lyon,fr Ligue 1,30,1990,33.1,0,0,0,0,0,0,0,,0,0,0,0,3,3,12,3
David López,es ESP,MFDF,Espanyol,es La Liga,31,1989,8.3,18,13,9,8,1,9,16,56.3,7,10,8,2,10,28,25,2
Diego López,es ESP,GK,Espanyol,es La Liga,39,1981,35.3,0,0,0,0,0,0,2,0.0,2,0,0,0,1,1,21,1
Javi López,es ESP,DF,Alavés,es La Liga,19,2002,5.1,8,6,6,2,0,4,6,66.7,2,7,1,6,4,12,15,0
Maxime Lopez,fr FRA,MF,Sassuolo,it Serie A,23,1997,32.6,69,36,40,27,2,35,87,40.2,52,33,7,26,42,111,38,1
Pau López,es ESP,GK,Marseille,fr Ligue 1,26,1994,29,0,0,0,0,0,0,1,0.0,1,0,0,0,0,0,12,1
Unai López,es ESP,MF,Rayo Vallecano,es La Liga,25,1995,12.9,19,9,6,10,3,10,33,30.3,23,7,0,7,10,29,8,1
Dion Lopy,sn SEN,MF,Reims,fr Ligue 1,19,2002,18.2,53,29,22,24,7,21,53,39.6,32,20,4,16,22,75,17,0
Samuel Loric,fr FRA,DF,Lorient,fr Ligue 1,21,2000,3,7,5,2,3,2,5,8,62.5,3,2,0,2,5,12,9,0
Anthony Losilla,fr FRA,MF,Bochum,de Bundesliga,35,1986,32.6,67,39,29,32,6,35,70,50.0,35,33,9,24,70,137,54,1
Jonas Lössl,dk DEN,GK,Brentford,eng Premier League,32,1989,2,0,0,0,0,0,0,0,,0,0,0,0,0,0,1,0
Marcel Lotka,pl POL,GK,Hertha BSC,de Bundesliga,20,2001,9.8,1,0,1,0,0,1,1,100.0,0,0,0,0,1,2,3,3
Jordan Lotomba,ch SUI,DF,Nice,fr Ligue 1,22,1998,19.8,33,17,21,9,3,16,30,53.3,14,17,4,13,12,45,28,0
Johaneko Louisjean,fr FRA,DF,Bordeaux,fr Ligue 1,17,2004,0.1,0,0,0,0,0,0,0,,0,0,0,0,0,0,0,0
Mamadou Loum,sn SEN,MF,Alavés,es La Liga,24,1996,25.7,49,22,26,22,1,17,45,37.8,28,30,11,19,37,86,68,1
Imran Louza,ma MAR,MF,Watford,eng Premier League,22,1999,15.7,41,21,18,20,3,16,38,42.1,22,28,6,22,42,83,20,1
Matteo Lovato,it ITA,DF,Atalanta,it Serie A,21,2000,3.4,5,4,4,1,0,0,1,0.0,1,4,2,2,7,12,8,0
Matteo Lovato,it ITA,DF,Cagliari,it Serie A,21,2000,13.8,23,15,13,10,0,8,20,40.0,12,21,10,11,28,51,43,0
Eduard Löwen,de GER,MF,Bochum,de Bundesliga,24,1997,15.7,33,22,12,13,8,11,45,24.4,34,17,2,15,9,42,15,1
Matthew Lowton,eng ENG,DF,Burnley,eng Premier League,32,1989,19.7,38,24,20,10,8,20,37,54.1,17,25,11,14,26,64,68,0
Anthony Lozano,hn HON,FWMF,Cádiz,es La Liga,28,1993,18.6,8,4,2,3,3,5,18,27.8,13,16,2,14,2,10,7,0
Hirving Lozano,mx MEX,FW,Napoli,it Serie A,26,1995,17.9,28,20,12,11,5,8,30,26.7,22,24,0,24,9,37,9,0
Jean Lucas,br BRA,MF,Monaco,fr Ligue 1,23,1998,16.1,43,25,14,24,5,17,40,42.5,23,15,5,10,13,56,4,1
Anderson Lucoqui,ao ANG,DF,Mainz 05,de Bundesliga,24,1997,8.3,22,10,11,6,5,11,22,50.0,11,15,3,12,11,33,10,0
Florentino Luís,pt POR,MF,Getafe,es La Liga,21,1999,11,42,25,22,17,3,17,35,48.6,18,21,2,19,21,63,11,1
José Luis Gayà,es ESP,DF,Valencia,es La Liga,26,1995,20.8,35,21,24,10,1,16,34,47.1,18,17,3,14,19,54,37,0
José Luis Morales,es ESP,FWMF,Levante,es La Liga,34,1987,30.2,27,17,6,9,12,12,42,28.6,30,29,0,29,4,31,7,0
José Luis Palomino,ar ARG,DF,Atalanta,it Serie A,31,1990,29.7,78,40,42,33,3,32,50,64.0,18,43,21,22,100,178,80,2
Luismi,es ESP,FWMF,Sevilla,es La Liga,20,2001,0.1,0,0,0,0,0,0,0,,0,0,0,0,0,0,0,0
Douglas Luiz,br BRA,MF,Aston Villa,eng Premier League,23,1998,30.2,59,39,30,24,5,21,72,29.2,51,30,7,23,34,93,28,1
Romelu Lukaku,be BEL,FW,Chelsea,eng Premier League,28,1993,17.7,2,1,0,1,1,1,5,20.0,4,11,1,10,0,2,20,0
Castello Lukeba,fr FRA,DF,Lyon,fr Ligue 1,18,2002,23.3,34,19,27,7,0,15,23,65.2,8,18,9,9,38,72,64,2
Dodi Lukebakio,be BEL,FW,Hertha BSC,de Bundesliga,23,1997,2,2,1,2,0,0,1,3,33.3,2,2,0,2,2,4,0,0
Dodi Lukebakio,be BEL,FWMF,Wolfsburg,de Bundesliga,23,1997,9.8,7,4,3,2,2,1,10,10.0,9,5,0,5,13,20,4,0
Saša Lukić,rs SRB,MF,Torino,it Serie A,24,1996,33.1,51,34,17,27,7,19,43,44.2,24,34,6,28,24,75,41,0
Levi Lumeka,eng ENG,MFFW,Troyes,fr Ligue 1,22,1998,0.7,0,0,0,0,0,0,2,0.0,2,0,0,0,0,0,2,0
Andriy Lunin,ua UKR,GK,Real Madrid,es La Liga,22,1999,2,0,0,0,0,0,0,0,,0,0,0,0,0,0,2,0
Andrey Lunyov,ru RUS,GK,Leverkusen,de Bundesliga,29,1991,1,0,0,0,0,0,0,0,,0,0,0,0,0,0,0,0
Sebastiano Luperto,it ITA,DF,Empoli,it Serie A,24,1996,21.8,29,17,17,10,2,10,20,50.0,10,32,26,6,45,74,132,0
Andreas Luthe,de GER,GK,Union Berlin,de Bundesliga,34,1987,27,0,0,0,0,0,0,1,0.0,1,0,0,0,0,0,11,4
Lyanco,br BRA,DF,Southampton,eng Premier League,24,1997,10.1,18,15,11,7,0,10,18,55.6,8,18,13,5,13,31,50,1
Charalambos Lykogiannis,gr GRE,DFFW,Cagliari,it Serie A,27,1993,20.2,19,12,16,1,2,11,20,55.0,9,18,8,10,31,50,73,0
Yannis M'Bemba,fr FRA,DFFW,Nantes,fr Ligue 1,20,2001,0.1,0,0,0,0,0,0,0,,0,0,0,0,0,0,1,0
Alexis Mac Allister,ar ARG,MFFW,Brighton,eng Premier League,22,1998,23.6,65,40,23,30,12,29,68,42.6,39,37,7,30,13,78,22,0
Deiver Machado,co COL,DFMF,Lens,fr Ligue 1,27,1993,5.8,16,14,11,1,4,12,14,85.7,2,9,1,8,3,19,12,1
Darwin Machís,ve VEN,MFFW,Granada,es La Liga,28,1993,15.3,23,13,11,8,4,9,23,39.1,14,10,0,10,15,38,17,0
Yvann Macon,fr FRA,DF,Saint-Étienne,fr Ligue 1,22,1998,17,41,22,24,14,3,16,42,38.1,26,18,4,14,18,59,27,0
James Maddison,eng ENG,MFFW,Leicester City,eng Premier League,24,1996,27.3,40,20,8,24,8,14,46,30.4,32,18,3,15,11,51,12,0
Niki Mäenpää,fi FIN,GK,Venezia,it Serie A,36,1985,16.5,0,0,0,0,0,0,0,,0,0,0,0,0,0,8,2
Pablo Maffeo,es ESP,DF,Mallorca,es La Liga,24,1997,32.7,84,47,48,28,8,38,69,55.1,31,30,13,17,46,130,74,0
Louis Mafouta,cf CTA,FW,Metz,fr Ligue 1,27,1994,5.8,0,0,0,0,0,0,5,0.0,5,1,0,1,0,0,4,0
Giulio Maggiore,it ITA,MF,Spezia,it Serie A,23,1998,31.3,58,32,20,32,6,31,77,40.3,46,30,5,25,29,87,33,0
Matej Maglica,hr CRO,MF,Stuttgart,de Bundesliga,22,1998,0.1,0,0,0,0,0,0,1,0.0,1,0,0,0,0,0,0,0
Francesco Magnanelli,it ITA,MF,Sassuolo,it Serie A,36,1984,3,5,4,4,1,0,1,9,11.1,8,3,1,2,1,6,3,0
Giangiacomo Magnani,it ITA,DF,Hellas Verona,it Serie A,25,1995,5.9,10,7,5,5,0,8,16,50.0,8,5,3,2,10,20,46,0
Giangiacomo Magnani,it ITA,DF,Sampdoria,it Serie A,25,1995,2.7,4,2,4,0,0,1,1,100.0,0,2,2,0,7,11,12,0
Hugo Magnetti,fr FRA,MF,Brest,fr Ligue 1,23,1998,16.3,50,34,27,20,3,22,50,44.0,28,13,3,10,25,75,13,0
Yohann Magnin,fr FRA,MFDF,Clermont Foot,fr Ligue 1,24,1997,19.1,53,31,22,26,5,24,42,57.1,18,17,7,10,20,73,36,0
Harry Maguire,eng ENG,DF,Manchester Utd,eng Premier League,28,1993,27.9,34,21,22,8,4,19,31,61.3,12,36,29,7,32,66,101,3
Riyad Mahrez,dz ALG,FW,Manchester City,eng Premier League,30,1991,16.6,11,3,5,4,2,5,19,26.3,14,15,1,14,6,17,6,0
Arne Maier,de GER,MF,Augsburg,de Bundesliga,22,1999,20.7,20,13,6,10,4,8,26,30.8,18,18,1,17,15,35,13,0
Habib Maïga,ci CIV,MF,Metz,fr Ligue 1,25,1996,14.1,47,28,29,13,5,24,48,50.0,24,20,7,13,14,61,18,0
Mike Maignan,fr FRA,GK,Milan,it Serie A,26,1995,32,2,1,2,0,0,2,2,100.0,0,0,0,0,1,3,4,2
Ainsley Maitland-Niles,eng ENG,MF,Arsenal,eng Premier League,23,1997,3,8,4,5,3,0,2,4,50.0,2,2,0,2,4,12,4,0
Ainsley Maitland-Niles,eng ENG,DF,Roma,it Serie A,23,1997,5.4,8,6,5,0,3,5,14,35.7,9,7,0,7,6,14,7,0
Josh Maja,ng NGA,FW,Bordeaux,fr Ligue 1,22,1998,0.1,0,0,0,0,0,0,0,,0,1,0,1,0,0,0,0
Abdul Majeed Waris,gh GHA,FWMF,Strasbourg,fr Ligue 1,29,1991,3.6,5,3,2,3,0,5,10,50.0,5,2,0,2,0,5,1,0
Lovro Majer,hr CRO,MFFW,Rennes,fr Ligue 1,23,1998,20.4,32,21,9,14,9,11,42,26.2,31,26,2,24,11,43,9,0
Jean-Victor Makengo,fr FRA,MF,Udinese,it Serie A,23,1998,26.1,30,21,7,17,6,15,29,51.7,14,26,6,20,19,49,17,0
Béni Makouana,cg CGO,FWMF,Montpellier,fr Ligue 1,18,2002,3.6,2,2,0,0,2,0,1,0.0,1,1,0,1,3,5,2,0
Nemanja Maksimović,rs SRB,MF,Getafe,es La Liga,26,1995,32.6,56,32,24,26,6,18,49,36.7,31,42,13,29,71,127,41,0
Nikola Maksimović,rs SRB,DF,Genoa,it Serie A,29,1991,12.4,14,6,10,4,0,7,9,77.8,2,17,11,6,12,26,61,1
Kévin Malcuit,ma MAR,DFMF,Napoli,it Serie A,30,1991,3.2,4,2,4,0,0,2,2,100.0,0,3,0,3,8,12,6,0
Daniel Maldini,it ITA,MF,Milan,it Serie A,19,2001,1.6,8,3,4,3,1,2,6,33.3,4,4,0,4,1,9,0,0
Youssef Maleh,it ITA,MF,Fiorentina,it Serie A,22,1998,11.3,27,16,8,13,6,12,25,48.0,13,14,1,13,6,33,2,0
Donyell Malen,nl NED,FW,Dortmund,de Bundesliga,22,1999,18.7,13,10,4,5,4,7,13,53.8,6,10,0,10,10,23,11,0
Ruslan Malinovskyi,ua UKR,MFFW,Atalanta,it Serie A,28,1993,17.7,18,10,3,10,5,5,19,26.3,14,27,3,24,5,23,1,0
Hugo Mallo,es ESP,DF,Celta Vigo,es La Liga,30,1991,20.3,45,25,24,19,2,16,31,51.6,15,23,9,14,20,65,53,0
Lennard Maloney,us USA,DF,Dortmund,de Bundesliga,21,1999,0.1,1,0,1,0,0,1,1,100.0,0,0,0,0,0,1,0,0
Mickael Malsa,mq MTQ,MF,Levante,es La Liga,25,1995,12.7,37,17,16,18,3,15,42,35.7,27,20,8,12,18,55,15,0
Giorgi Mamardashvili,ge GEO,GK,Valencia,es La Liga,20,2000,18,0,0,0,0,0,0,0,,0,0,0,0,0,0,6,1
Rey Manaj,al ALB,FW,Spezia,it Serie A,24,1997,19.6,19,12,3,11,5,6,26,23.1,20,16,0,16,4,23,13,0
Hianga Mananga Mbock,fr FRA,MF,Brest,fr Ligue 1,21,1999,8.9,18,12,8,7,3,9,21,42.9,12,5,2,3,5,23,6,0
Vincent Manceau,fr FRA,DF,Angers,fr Ligue 1,32,1989,26.2,32,19,18,13,1,14,37,37.8,23,23,6,17,32,64,72,0
Gianluca Mancini,it ITA,DF,Roma,it Serie A,25,1996,32,41,25,22,18,1,18,33,54.5,15,38,19,19,39,80,69,0
Leonardo Mancuso,it ITA,FW,Empoli,it Serie A,29,1992,4.7,1,1,0,1,0,0,6,0.0,6,2,0,2,1,2,2,0
Steve Mandanda,fr FRA,GK,Marseille,fr Ligue 1,36,1985,9,0,0,0,0,0,0,1,0.0,1,1,0,1,1,1,4,1
Reinildo Mandava,mz MOZ,DF,Atlético Madrid,es La Liga,27,1994,14.4,45,25,30,14,1,22,30,73.3,8,18,9,9,21,66,38,0
Reinildo Mandava,mz MOZ,DF,Lille,fr Ligue 1,27,1994,16.9,43,23,29,11,3,32,51,62.7,19,13,4,9,37,80,55,0
Aïssa Mandi,dz ALG,DF,Villarreal,es La Liga,29,1991,15.3,11,5,2,8,1,3,6,50.0,3,17,14,3,13,24,49,3
Rolando Mandragora,it ITA,MF,Torino,it Serie A,24,1997,14.7,21,10,3,16,2,12,21,57.1,9,18,4,14,10,31,13,0
Anthony Mandrea,dz ALG,GK,Angers,fr Ligue 1,24,1996,10,0,0,0,0,0,0,0,,0,0,0,0,0,0,9,0
Sadio Mané,sn SEN,FW,Liverpool,eng Premier League,29,1992,31.3,33,20,7,14,12,8,26,30.8,18,30,1,29,8,41,15,0
Eliaquim Mangala,fr FRA,DF,Saint-Étienne,fr Ligue 1,30,1991,13.1,17,12,12,5,0,8,12,66.7,4,11,8,3,17,34,61,1
Orel Mangala,be BEL,MF,Stuttgart,de Bundesliga,23,1998,20.6,17,10,5,7,5,11,22,50.0,11,11,4,7,12,29,19,1
Thomas Mangani,fr FRA,MF,Angers,fr Ligue 1,34,1987,24.4,58,30,23,34,1,31,68,45.6,37,38,11,27,36,94,29,0
Ricardo Mangas,pt POR,DF,Bordeaux,fr Ligue 1,23,1998,26.1,35,22,22,8,5,26,41,63.4,15,18,4,14,25,60,47,3
Kostas Manolas,gr GRE,DF,Napoli,it Serie A,30,1991,3.5,2,2,1,1,0,2,3,66.7,1,2,1,1,4,6,10,1
Javier Manquillo,es ESP,DF,Newcastle Utd,eng Premier League,27,1994,14,39,29,28,10,1,21,36,58.3,15,15,6,9,10,49,32,0
Myziane Maolida,fr FRA,MF,Nice,fr Ligue 1,22,1999,0.4,1,0,0,1,0,0,0,,0,1,0,1,0,1,0,0
Myziane Maolida,fr FRA,FWMF,Hertha BSC,de Bundesliga,22,1999,8.6,7,4,5,1,1,3,9,33.3,6,5,0,5,1,8,6,0
Sekou Mara,fr FRA,FWMF,Bordeaux,fr Ligue 1,19,2002,10.1,8,4,1,1,6,1,8,12.5,7,7,0,7,2,10,6,0
Maranhão,br BRA,FWMF,Valencia,es La Liga,24,1996,10.8,15,11,4,6,5,5,16,31.3,11,15,0,15,7,22,13,0
Nikola Maraš,rs SRB,DF,Rayo Vallecano,es La Liga,25,1995,11.6,13,9,12,1,0,9,15,60.0,6,17,13,4,15,28,51,0
Fernando Marçal,br BRA,MFDF,Wolves,eng Premier League,32,1989,16.1,42,22,27,14,1,21,37,56.8,16,25,4,21,28,70,52,0
Marcelo,br BRA,DF,Real Madrid,es La Liga,33,1988,5.8,8,4,2,3,3,5,10,50.0,5,7,2,5,1,9,11,0
Marcelo,br BRA,DF,Bordeaux,fr Ligue 1,34,1987,10,9,5,7,2,0,4,6,66.7,2,4,3,1,13,22,46,1
Marcelo,br BRA,DF,Lyon,fr Ligue 1,34,1987,2,4,3,0,4,0,4,6,66.7,2,3,2,1,4,8,10,0
Solly March,eng ENG,DFFW,Brighton,eng Premier League,27,1994,19.4,30,17,11,9,10,7,22,31.8,15,22,3,19,17,47,25,0
Riccardo Marchizza,it ITA,DF,Empoli,it Serie A,23,1998,15,21,15,11,8,2,11,16,68.8,5,15,6,9,10,31,24,0
Gian Marco Ferrari,it ITA,DF,Sassuolo,it Serie A,29,1992,34.7,16,11,10,6,0,10,23,43.5,13,37,27,10,43,59,114,2
Iván Marcone,ar ARG,MF,Elche,es La Liga,31,1990,9,24,14,17,6,1,12,24,50.0,12,8,3,5,12,36,13,0
Óscar de Marcos,es ESP,DF,Athletic Club,es La Liga,32,1989,18.7,50,37,24,19,7,28,43,65.1,15,20,3,17,19,69,27,0
Davide Marfella,it ITA,GK,Napoli,it Serie A,21,1999,0.1,0,0,0,0,0,0,0,,0,0,0,0,0,0,0,0
José Mari,es ESP,MF,Cádiz,es La Liga,33,1987,4.3,14,7,3,10,1,7,8,87.5,1,4,1,3,7,21,2,0
Pablo Marí,es ESP,DF,Arsenal,eng Premier League,27,1993,2,5,3,1,3,1,3,6,50.0,3,5,4,1,3,8,10,0
Pablo Marí,es ESP,DF,Udinese,it Serie A,27,1993,14.9,16,8,8,6,2,8,16,50.0,8,18,12,6,21,37,72,0
José María Giménez,uy URU,DF,Atlético Madrid,es La Liga,26,1995,22.7,18,12,12,6,0,8,16,50.0,8,25,19,6,25,43,96,1
Mariano,do DOM,FW,Real Madrid,es La Liga,27,1993,3.8,2,0,2,0,0,0,0,,0,2,0,2,1,3,3,0
Răzvan Marin,ro ROU,MF,Cagliari,it Serie A,25,1996,31.3,42,21,16,22,4,24,54,44.4,30,23,5,18,10,52,17,1
Guillermo Maripán,cl CHI,DF,Monaco,fr Ligue 1,27,1994,20.4,36,24,27,9,0,20,40,50.0,20,21,14,7,25,61,66,1
Mika Màrmol,es ESP,DF,Barcelona,es La Liga,19,2002,0,0,0,0,0,0,0,0,,0,0,0,0,0,0,0,0
Omar Marmoush,eg EGY,FW,Wolfsburg,de Bundesliga,22,1999,0.3,0,0,0,0,0,0,0,,0,0,0,0,0,0,0,0
Omar Marmoush,eg EGY,FW,Stuttgart,de Bundesliga,22,1999,17.5,26,17,6,14,6,4,20,20.0,16,9,1,8,7,33,6,0
Marquinhos,br BRA,DF,Paris S-G,fr Ligue 1,27,1994,31.8,37,14,25,11,1,20,35,57.1,15,35,19,16,16,53,102,0
Roger Martí,es ESP,FW,Levante,es La Liga,30,1991,23.5,23,14,3,13,7,8,30,26.7,22,14,0,14,2,25,8,0
Anthony Martial,fr FRA,FW,Manchester Utd,eng Premier League,25,1995,2.4,0,0,0,0,0,0,1,0.0,1,1,0,1,0,0,1,0
Anthony Martial,fr FRA,FWMF,Sevilla,es La Liga,25,1995,5.4,2,1,0,0,2,2,6,33.3,4,4,0,4,0,2,3,0
Martín,es ESP,MF,Cádiz,es La Liga,22,1999,1.3,2,2,0,2,0,0,0,,0,1,0,1,1,3,3,0
Aarón Martín,es ESP,DF,Mainz 05,de Bundesliga,24,1997,25.5,54,33,32,18,4,24,55,43.6,31,24,4,20,20,74,35,0
Ander Martin,es ESP,FWMF,Real Sociedad,es La Liga,20,2000,1,1,0,0,1,0,1,1,100.0,0,0,0,0,3,4,1,0
Andrés Martín,es ESP,FWMF,Rayo Vallecano,es La Liga,22,1999,2.1,0,0,0,0,0,0,1,0.0,1,1,0,1,0,0,0,0
Carlos Martín,es ESP,DF,Atlético Madrid,es La Liga,19,2002,0.1,0,0,0,0,0,0,0,,0,0,0,0,0,0,1,0
Iván Martín,es ESP,MFFW,Alavés,es La Liga,22,1999,1.8,1,1,1,0,0,0,1,0.0,1,2,0,2,1,2,1,0
Jonas Martin,fr FRA,MF,Rennes,fr Ligue 1,31,1990,23.4,35,20,12,21,2,19,53,35.8,34,17,3,14,22,57,28,1
Martinelli,br BRA,FWMF,Arsenal,eng Premier League,20,2001,20.7,27,19,7,14,6,10,29,34.5,19,26,1,25,20,47,15,0
Emiliano Martínez,ar ARG,GK,Aston Villa,eng Premier League,28,1992,36,1,1,1,0,0,1,3,33.3,2,0,0,0,0,1,6,1
Iñigo Martínez,es ESP,DF,Athletic Club,es La Liga,30,1991,26,28,13,18,7,3,14,23,60.9,9,22,10,12,39,67,143,0
Javi Martínez,es ESP,MFFW,Osasuna,es La Liga,21,1999,9.8,21,14,8,11,2,10,29,34.5,19,6,0,6,9,30,10,0
Josep Martinez,es ESP,GK,RB Leipzig,de Bundesliga,23,1998,1,0,0,0,0,0,0,0,,0,0,0,0,0,0,0,0
Lautaro Martínez,ar ARG,FW,Inter,it Serie A,23,1997,25.4,20,10,3,10,7,6,11,54.5,5,21,1,20,18,38,6,0
Pablo Martínez,es ESP,MF,Levante,es La Liga,23,1998,7.3,15,8,7,8,0,4,13,30.8,9,6,3,3,15,30,5,0
Lucas Martínez Quarta,ar ARG,DF,Fiorentina,it Serie A,25,1996,15.9,36,25,23,11,2,21,34,61.8,13,22,9,13,19,55,46,0
Gelson Martins,pt POR,MFFW,Monaco,fr Ligue 1,26,1995,21.2,42,27,10,26,6,21,59,35.6,38,26,1,25,17,59,4,0
Adam Marušić,me MNE,DF,Lazio,it Serie A,28,1992,30.2,30,18,16,12,2,13,32,40.6,19,19,8,11,41,71,71,0
Omar Mascarell,es ESP,MF,Elche,es La Liga,28,1993,27.7,46,26,16,23,7,24,60,40.0,36,42,14,28,48,94,52,2
Andrea Masiello,it ITA,DF,Genoa,it Serie A,35,1986,5.7,5,3,4,1,0,4,7,57.1,3,8,4,4,11,16,20,1
Adam Masina,ma MAR,DF,Watford,eng Premier League,27,1994,12,24,13,11,10,3,12,29,41.4,17,18,6,12,18,42,45,0
Erhan Mašović,rs SRB,DF,Bochum,de Bundesliga,22,1998,17.2,37,20,22,14,1,22,35,62.9,13,31,20,11,34,71,65,1
Roberto Massimo,de GER,DFFW,Stuttgart,de Bundesliga,20,2000,9.7,14,5,6,7,1,4,16,25.0,12,9,0,9,3,17,6,0
Arthur Masuaku,cd COD,DFFW,West Ham,eng Premier League,27,1993,7.2,31,23,19,11,1,14,23,60.9,9,9,1,8,9,40,17,0
Jaime Mata,es ESP,FW,Getafe,es La Liga,32,1988,7.5,7,5,3,1,3,1,9,11.1,8,4,1,3,1,8,5,0
Juan Mata,es ESP,MF,Manchester Utd,eng Premier League,33,1988,2.6,6,4,2,3,1,3,5,60.0,2,1,0,1,1,7,1,0
Pape Matar Sarr,sn SEN,MF,Metz,fr Ligue 1,18,2002,23.7,45,26,21,23,1,18,39,46.2,21,33,3,30,29,74,22,0
Eliot Matazo,be BEL,MF,Monaco,fr Ligue 1,19,2002,8.8,8,7,4,4,0,2,11,18.2,9,11,3,8,13,21,9,0
Aleš Matějů,cz CZE,DF,Venezia,it Serie A,25,1996,8.1,16,12,10,5,1,13,29,44.8,16,10,6,4,9,25,15,0
Jean-Philippe Mateta,fr FRA,FW,Crystal Palace,eng Premier League,24,1997,12.7,8,4,2,5,1,3,18,16.7,15,11,3,8,4,12,13,0
Nemanja Matić,rs SRB,MF,Manchester Utd,eng Premier League,32,1988,15.4,31,18,19,11,1,15,31,48.4,16,21,6,15,31,62,21,3
Joël Matip,cm CMR,DF,Liverpool,eng Premier League,29,1991,31,47,34,23,19,5,20,31,64.5,11,26,14,12,44,91,93,1
Chrislain Matsima,fr FRA,DF,Monaco,fr Ligue 1,19,2002,1.5,3,2,1,2,0,2,7,28.6,5,3,3,0,1,4,6,1
Azor Matusiwa,nl NED,MF,Reims,fr Ligue 1,23,1998,27.4,58,32,28,26,4,26,55,47.3,29,49,19,30,62,120,43,0
Neal Maupay,fr FRA,FW,Brighton,eng Premier League,24,1996,25.3,17,10,2,6,9,4,18,22.2,14,21,2,19,2,19,2,0
Stephy Mavididi,eng ENG,FWMF,Montpellier,fr Ligue 1,23,1998,25.5,24,13,11,7,6,14,39,35.9,25,23,2,21,8,32,11,0
Konstantinos Mavropanos,gr GRE,DF,Stuttgart,de Bundesliga,23,1997,30.1,57,39,35,21,1,30,51,58.8,21,46,23,23,69,126,174,2
Eric Maxim Choupo-Moting,cm CMR,FWMF,Bayern Munich,de Bundesliga,32,1989,4.2,10,9,3,6,1,3,10,30.0,7,1,0,1,5,15,2,0
Luís Maximiano,pt POR,GK,Granada,es La Liga,22,1999,34.8,3,1,3,0,0,3,6,50.0,3,0,0,0,1,4,16,2
Borja Mayoral,es ESP,FWDF,Roma,it Serie A,24,1997,1.1,0,0,0,0,0,0,0,,0,0,0,0,0,0,0,0
Borja Mayoral,es ESP,FW,Getafe,es La Liga,24,1997,11.6,7,5,2,3,2,1,2,50.0,1,10,4,6,4,11,3,0
Derek Mazou-Sacko,fr FRA,FWDF,Troyes,fr Ligue 1,16,2004,0,1,0,0,0,1,1,1,100.0,0,0,0,0,0,1,1,0
Pasquale Mazzocchi,it ITA,DF,Venezia,it Serie A,26,1995,13.8,18,8,11,4,3,10,26,38.5,16,11,8,3,21,39,31,1
Pasquale Mazzocchi,it ITA,DF,Salernitana,it Serie A,26,1995,14.1,28,19,15,11,2,14,34,41.2,20,5,0,5,11,39,31,0
Kevin Mbabu,ch SUI,DF,Wolfsburg,de Bundesliga,26,1995,15.5,31,20,21,5,5,12,23,52.2,11,25,8,17,35,66,35,0
Kylian Mbappé,fr FRA,FW,Paris S-G,fr Ligue 1,22,1998,33.6,11,8,1,4,6,7,13,53.8,6,6,0,6,5,16,13,0
Ibrahima Mbaye,sn SEN,DF,Bologna,it Serie A,26,1994,1.2,1,1,1,0,0,1,2,50.0,1,1,1,0,1,2,6,0
Amadou Mbengue,sn SEN,DFMF,Metz,fr Ligue 1,19,2002,6.8,19,10,10,9,0,11,22,50.0,11,7,2,5,10,29,19,0
Bryan Mbeumo,cm CMR,FW,Brentford,eng Premier League,21,1999,32.3,28,16,1,12,15,6,20,30.0,14,21,6,15,11,39,20,0
Jason Mbock,fr FRA,FW,Angers,fr Ligue 1,21,1999,0.2,0,0,0,0,0,0,0,,0,0,0,0,0,0,0,0
Jordi Mboula,es ESP,FW,Mallorca,es La Liga,22,1999,4.8,8,2,3,3,2,5,9,55.6,4,7,1,6,3,11,3,0
Moustapha Mbow,sn SEN,DF,Reims,fr Ligue 1,21,2000,1,6,6,3,2,1,3,3,100.0,0,0,0,0,1,7,6,0
Nathanael Mbuku,fr FRA,FWMF,Reims,fr Ligue 1,19,2002,15.8,14,13,4,7,3,2,8,25.0,6,14,0,14,11,25,4,0
James McArthur,sct SCO,MF,Crystal Palace,eng Premier League,33,1987,16,33,23,13,19,1,16,44,36.4,28,23,9,14,30,63,27,0
James Mcatee,eng ENG,MFFW,Manchester City,eng Premier League,18,2002,0.2,0,0,0,0,0,0,2,0.0,2,0,0,0,0,0,0,0
Kasey McAteer,eng ENG,FW,Leicester City,eng Premier League,19,2001,0,0,0,0,0,0,0,0,,0,0,0,0,0,0,0,0
Liam McCarron,sct SCO,FW,Leeds United,eng Premier League,20,2001,0.1,0,0,0,0,0,0,0,,0,1,0,1,0,0,0,0
Alex McCarthy,eng ENG,GK,Southampton,eng Premier League,31,1989,17,0,0,0,0,0,0,0,,0,0,0,0,0,0,4,0
John McGinn,sct SCO,MF,Aston Villa,eng Premier League,26,1994,34.3,106,64,35,55,16,54,104,51.9,50,53,6,47,35,141,34,0
Weston McKennie,us USA,MF,Juventus,it Serie A,22,1998,15.2,20,11,11,7,2,8,26,30.8,18,17,8,9,23,43,20,0
Stuart McKinstry,sct SCO,MF,Leeds United,eng Premier League,18,2002,0,0,0,0,0,0,0,0,,0,0,0,0,0,0,0,0
Kenny McLean,sct SCO,MF,Norwich City,eng Premier League,29,1992,30.1,42,22,18,20,4,17,59,28.8,42,29,7,22,34,76,54,0
Dwight McNeil,eng ENG,MF,Burnley,eng Premier League,21,1999,34.5,78,49,27,38,13,33,73,45.2,40,64,11,53,35,113,31,1
Scott McTominay,sct SCO,MF,Manchester Utd,eng Premier League,24,1996,26.5,65,33,32,24,9,30,61,49.2,31,45,10,35,31,96,60,1
Gary Medel,cl CHI,DF,Bologna,it Serie A,33,1987,31.4,39,23,27,11,1,16,36,44.4,20,30,21,9,44,83,112,0
Facundo Medina,ar ARG,DF,Lens,fr Ligue 1,22,1999,28.8,61,42,34,23,4,38,62,61.3,24,24,8,16,37,98,78,3
Nathan de Medina,be BEL,DF,Arminia,de Bundesliga,23,1997,8.6,17,10,11,6,0,6,10,60.0,4,14,3,11,10,27,28,0
Ben Mee,eng ENG,DF,Burnley,eng Premier League,31,1989,20.4,26,12,16,7,3,12,19,63.2,7,28,22,6,24,50,94,1
Admir Mehmedi,ch SUI,DF,Wolfsburg,de Bundesliga,30,1991,0,0,0,0,0,0,0,0,,0,0,0,0,0,0,0,0
Hannibal Mejbri,tn TUN,FW,Manchester Utd,eng Premier League,18,2003,0.8,2,1,1,1,0,1,1,100.0,0,0,0,0,0,2,0,0
Farid El Melali,dz ALG,FW,Angers,fr Ligue 1,24,1997,0.2,0,0,0,0,0,0,1,0.0,1,1,0,1,0,0,1,0
Filippo Melegoni,it ITA,MFFW,Genoa,it Serie A,22,1999,10.9,20,12,5,8,7,8,16,50.0,8,10,1,9,11,31,8,1
Óscar Melendo,es ESP,MFFW,Espanyol,es La Liga,23,1997,11,11,5,4,4,3,3,13,23.1,10,4,1,3,1,12,10,0
Gonzalo Melero,es ESP,MF,Levante,es La Liga,27,1994,18.8,29,16,10,15,4,16,36,44.4,20,21,8,13,7,36,22,0
Birger Meling,no NOR,DF,Rennes,fr Ligue 1,26,1994,20.3,43,27,25,11,7,23,31,74.2,8,23,7,16,22,65,40,0
Arthur Melo,br BRA,MF,Juventus,it Serie A,24,1996,10.7,25,12,10,14,1,13,24,54.2,11,11,2,9,7,32,8,1
Memphis,nl NED,FW,Barcelona,es La Liga,27,1994,20.6,10,4,2,4,4,3,13,23.1,10,9,1,8,3,13,4,0
Houboulang Mendes,fr FRA,DF,Lorient,fr Ligue 1,23,1998,35.8,58,28,37,18,3,40,57,70.2,17,41,21,20,41,99,128,4
Nuno Mendes,pt POR,DF,Paris S-G,fr Ligue 1,19,2002,18.4,48,29,23,18,7,25,47,53.2,22,27,5,22,21,69,17,1
Pedro Mendes,pt POR,DF,Montpellier,fr Ligue 1,30,1990,0.2,1,1,1,0,0,0,0,,0,1,1,0,0,1,2,0
Thiago Mendes,br BRA,MFDF,Lyon,fr Ligue 1,29,1992,20.7,36,22,18,16,2,12,30,40.0,18,24,5,19,34,70,56,1
Tomás Mendes,es ESP,MF,Alavés,es La Liga,16,2004,0.1,0,0,0,0,0,0,0,,0,0,0,0,0,0,1,0
Brais Méndez,es ESP,MF,Celta Vigo,es La Liga,24,1997,33.6,68,35,24,35,9,26,87,29.9,61,52,6,46,37,105,30,0
Édgar Méndez,es ESP,FWMF,Alavés,es La Liga,31,1990,17.9,25,14,11,10,4,11,34,32.4,23,16,0,16,4,29,17,0
Arial Mendy,sn SEN,DFFW,Clermont Foot,fr Ligue 1,26,1994,8.8,6,4,4,2,0,2,11,18.2,9,6,1,5,7,13,17,0
Batista Mendy,fr FRA,MFDF,Angers,fr Ligue 1,21,2000,26.8,49,28,21,22,6,23,45,51.1,22,37,6,31,34,83,40,0
Benjamin Mendy,fr FRA,DF,Manchester City,eng Premier League,27,1994,0.9,2,2,1,1,0,2,6,33.3,4,0,0,0,0,2,0,0
Edouard Mendy,sn SEN,GK,Chelsea,eng Premier League,29,1992,34,1,0,1,0,0,1,3,33.3,2,0,0,0,0,1,13,4
Ferland Mendy,fr FRA,DF,Real Madrid,es La Liga,26,1995,19.3,24,14,11,10,3,8,14,57.1,6,8,2,6,18,42,27,3
Nampalys Mendy,sn SEN,MF,Leicester City,eng Premier League,29,1992,11.5,12,6,8,4,0,6,17,35.3,11,7,4,3,11,23,11,1
Gideon Mensah,gh GHA,DF,Bordeaux,fr Ligue 1,23,1998,13.4,37,24,19,12,6,18,38,47.4,20,11,2,9,16,53,21,0
Jorge Meré,es ESP,DF,Köln,de Bundesliga,24,1997,5.4,9,6,3,6,0,4,7,57.1,3,6,4,2,10,19,19,0
Alex Meret,it ITA,GK,Napoli,it Serie A,24,1997,6.9,0,0,0,0,0,0,0,,0,0,0,0,0,0,3,1
Fran Mérida,es ESP,MF,Espanyol,es La Liga,31,1990,3,7,3,5,2,0,4,10,40.0,6,1,0,1,6,13,1,0
Mikel Merino,es ESP,MF,Real Sociedad,es La Liga,25,1996,32.1,71,38,21,40,10,26,67,38.8,41,50,10,40,21,92,56,2
Quentin Merlin,fr FRA,DFMF,Nantes,fr Ligue 1,19,2002,21.4,45,28,19,20,6,26,49,53.1,23,25,4,21,27,72,29,2
Martín Merquelanz,es ESP,FWMF,Rayo Vallecano,es La Liga,26,1995,1.9,2,1,2,0,0,2,6,33.3,4,2,0,2,0,2,1,0
Yıldırım Mert Çetin,tr TUR,MF,Hellas Verona,it Serie A,24,1997,0.5,1,0,1,0,0,1,1,100.0,0,0,0,0,0,1,2,0
Dries Mertens,be BEL,FWMF,Napoli,it Serie A,34,1987,15.4,16,7,1,11,4,3,16,18.8,13,8,2,6,9,25,2,0
Illan Meslier,fr FRA,GK,Leeds United,eng Premier League,21,2000,37.6,1,1,1,0,0,1,1,100.0,0,0,0,0,0,1,27,1
Lionel Messi,ar ARG,FWMF,Paris S-G,fr Ligue 1,34,1987,23.9,10,3,1,5,4,3,13,23.1,10,5,0,5,4,14,0,0
Junior Messias,br BRA,FWMF,Milan,it Serie A,30,1991,15.9,34,18,11,14,9,15,34,44.1,19,11,1,10,17,51,17,0
Thomas Meunier,be BEL,DF,Dortmund,de Bundesliga,29,1991,15.6,29,19,13,12,4,16,33,48.5,17,10,2,8,12,41,25,1
Mexer,mz MOZ,DF,Bordeaux,fr Ligue 1,32,1988,13.6,14,10,11,3,0,11,17,64.7,6,12,7,5,21,35,60,2
Marco Meyerhöfer,de GER,DF,Greuther Fürth,de Bundesliga,25,1995,25.3,53,35,22,22,9,24,37,64.9,13,38,19,19,47,100,64,1
Matt Miazga,us USA,DF,Alavés,es La Liga,26,1995,9.3,7,7,3,4,0,2,7,28.6,5,14,12,2,11,18,55,1
Kingsley Michael,ng NGA,MF,Bologna,it Serie A,21,1999,0.8,4,1,2,2,0,1,2,50.0,1,2,1,1,1,5,1,1
Sven Michel,de GER,FW,Union Berlin,de Bundesliga,31,1990,3.8,10,6,5,3,2,2,8,25.0,6,3,0,3,1,11,1,0
Edouard Michut,fr FRA,MF,Paris S-G,fr Ligue 1,18,2003,0.8,0,0,0,0,0,0,2,0.0,2,2,0,2,1,1,2,0
Miguel,es ESP,FWMF,Alavés,es La Liga,21,1999,9.2,7,3,1,5,1,2,15,13.3,13,6,0,6,1,8,7,0
Valentin Mihaila,ro ROU,MFFW,Atalanta,it Serie A,21,2000,0.8,1,1,0,1,0,0,1,0.0,1,2,0,2,0,1,0,0
Mikael,br BRA,FWMF,Salernitana,it Serie A,22,1999,1,1,1,0,1,0,0,0,,0,0,0,0,0,1,1,0
Hilmir Mikaelsson,is ISL,FW,Venezia,it Serie A,17,2004,0.2,2,0,0,1,1,0,0,,0,0,0,0,0,2,0,0
Georges Mikautadze,ge GEO,FW,Metz,fr Ligue 1,20,2000,0,0,0,0,0,0,0,0,,0,0,0,0,0,0,0,0
William Mikelbrencis,fr FRA,DF,Metz,fr Ligue 1,17,2004,6.8,11,5,6,4,1,6,9,66.7,3,6,3,3,5,16,9,0
Nikola Milenković,rs SRB,DF,Fiorentina,it Serie A,23,1997,32.5,54,32,31,20,3,29,34,85.3,5,30,15,15,39,93,94,0
Arkadiusz Milik,pl POL,FW,Marseille,fr Ligue 1,27,1994,15.7,9,2,0,5,4,4,18,22.2,14,9,1,8,3,12,10,1
Sergej Milinković-Savić,rs SRB,MF,Lazio,it Serie A,26,1995,34.4,67,44,20,32,15,29,67,43.3,38,50,9,41,34,101,43,1
Vanja Milinković-Savić,rs SRB,GK,Torino,it Serie A,24,1997,27,0,0,0,0,0,0,1,0.0,1,0,0,0,0,0,7,2
Éder Militão,br BRA,DF,Real Madrid,es La Liga,23,1998,33.7,50,32,30,12,8,20,39,51.3,19,42,20,22,52,102,107,3
Luka Milivojević,rs SRB,MF,Crystal Palace,eng Premier League,30,1991,8.6,18,9,9,6,3,10,16,62.5,6,6,1,5,11,29,15,0
Luis Milla,es ESP,MF,Granada,es La Liga,26,1994,30.8,59,29,25,30,4,25,64,39.1,39,28,4,24,25,84,34,0
Pere Milla,es ESP,MFFW,Elche,es La Liga,28,1992,18.3,20,15,14,5,1,8,44,18.2,36,21,1,20,5,25,21,0
Enzo Millot,fr FRA,MF,Stuttgart,de Bundesliga,19,2002,0.6,2,0,0,2,0,0,1,0.0,1,0,0,0,1,3,1,0
James Milner,eng ENG,MFDF,Liverpool,eng Premier League,35,1986,9.5,28,16,12,11,5,12,29,41.4,17,19,5,14,17,45,20,0
Santi Mina,es ESP,FW,Celta Vigo,es La Liga,25,1995,26.3,27,17,8,15,4,5,32,15.6,27,28,2,26,6,33,22,0
Yerry Mina,co COL,DF,Everton,eng Premier League,26,1994,9.4,12,10,12,0,0,10,13,76.9,3,13,9,4,11,23,38,1
Takumi Minamino,jp JPN,FWMF,Liverpool,eng Premier League,26,1995,2.1,3,2,1,1,1,2,8,25.0,6,2,0,2,1,4,2,0
Tyrone Mings,eng ENG,DF,Aston Villa,eng Premier League,28,1993,35.4,23,12,17,3,3,14,22,63.6,8,47,30,17,46,69,153,2
Óscar Mingueza,es ESP,DF,Barcelona,es La Liga,22,1999,9.9,25,11,12,11,2,16,23,69.6,7,5,0,5,9,34,22,1
Rafa Mir,es ESP,FW,Sevilla,es La Liga,24,1997,20.1,4,3,1,1,2,0,11,0.0,11,4,3,1,0,4,17,0
Jorge Miramón,es ESP,DF,Levante,es La Liga,32,1989,22,36,19,16,12,8,15,44,34.1,29,15,3,12,35,71,58,0
Aleksei Miranchuk,ru RUS,MFFW,Atalanta,it Serie A,25,1995,8.6,11,7,3,7,1,4,12,33.3,8,3,0,3,1,12,7,0
Juan Miranda,es ESP,DF,Betis,es La Liga,21,2000,8.7,21,11,16,4,1,12,22,54.5,10,10,4,6,15,36,22,0
Fabio Miretti,it ITA,MF,Juventus,it Serie A,17,2003,3.6,4,2,2,2,0,2,9,22.2,7,3,1,2,2,6,3,0
Tyrick Mitchell,eng ENG,DF,Crystal Palace,eng Premier League,21,1999,34.5,104,57,67,26,11,46,67,68.7,21,47,5,42,41,145,101,0
Stefan Mitrović,rs SRB,DF,Getafe,es La Liga,31,1990,29.6,16,8,12,4,0,8,13,61.5,5,28,18,10,22,38,114,1
Maximilian Mittelstädt,de GER,DFFW,Hertha BSC,de Bundesliga,24,1997,16.6,52,33,30,12,10,26,50,52.0,24,28,5,23,46,98,37,0
Henrikh Mkhitaryan,am ARM,MFFW,Roma,it Serie A,32,1989,27.7,45,29,11,27,7,17,52,32.7,35,33,2,31,22,67,33,0
Jakub Moder,pl POL,MF,Brighton,eng Premier League,22,1999,18.9,42,25,18,17,7,23,42,54.8,19,25,2,23,10,52,22,1
Anthony Modeste,fr FRA,FW,Köln,de Bundesliga,33,1988,29,10,6,4,5,1,3,18,16.7,15,11,2,9,4,14,29,0
Marco Modolo,it ITA,DF,Venezia,it Serie A,32,1989,4.4,6,3,4,2,0,2,5,40.0,3,6,6,0,4,10,26,0
Luka Modrić,hr CRO,MF,Real Madrid,es La Liga,35,1985,22.6,18,10,8,7,3,6,27,22.2,21,10,4,6,20,38,9,0
Terem Moffi,ng NGA,FW,Lorient,fr Ligue 1,22,1999,30.1,17,10,3,12,2,9,32,28.1,23,11,2,9,4,21,22,0
Kevin Möhwald,de GER,MF,Union Berlin,de Bundesliga,28,1993,3.9,7,1,3,3,1,1,7,14.3,6,3,0,3,3,10,6,0
Dion Moise Sahi,ci CIV,FWMF,Strasbourg,fr Ligue 1,19,2001,1.4,0,0,0,0,0,0,0,,0,1,0,1,1,1,1,0
Johan Mojica,co COL,DF,Elche,es La Liga,28,1992,31.7,46,25,34,7,5,23,31,74.2,8,22,3,19,25,71,61,3
Clinton Mola,eng ENG,DF,Stuttgart,de Bundesliga,20,2001,1.3,3,1,2,1,0,2,4,50.0,2,5,5,0,3,6,2,0
Jorge Molina,es ESP,FW,Granada,es La Liga,39,1982,21.8,4,2,2,1,1,2,18,11.1,16,13,2,11,6,10,11,0
Nahuel Molina,ar ARG,DF,Udinese,it Serie A,23,1998,29.3,41,24,17,21,3,16,48,33.3,32,24,3,21,22,63,44,2
Cristian Molinaro,it ITA,DF,Venezia,it Serie A,38,1983,6.1,12,9,10,2,0,5,7,71.4,2,7,2,5,6,18,20,0
Florent Mollet,fr FRA,FWMF,Montpellier,fr Ligue 1,29,1991,29.2,31,22,14,12,5,14,57,24.6,43,27,4,23,24,55,13,0
Jon Moncayola,es ESP,MF,Osasuna,es La Liga,23,1998,32.4,40,20,18,18,4,17,44,38.6,27,26,9,17,20,60,43,0
Monchu,es ESP,MF,Granada,es La Liga,21,1999,7.4,15,6,5,9,1,5,10,50.0,5,8,3,5,4,19,4,0
Thomas Monconduit,fr FRA,MF,Lorient,fr Ligue 1,30,1991,25,41,25,19,17,5,20,57,35.1,37,21,10,11,22,63,51,1
Gonzalo Montiel,ar ARG,DF,Sevilla,es La Liga,24,1997,11.8,15,4,8,5,2,12,24,50.0,12,8,2,6,10,25,22,0
Lorenzo Montipò,it ITA,GK,Hellas Verona,it Serie A,25,1996,34,0,0,0,0,0,0,0,,0,0,0,0,1,1,16,3
Ángel Montoro,es ESP,MF,Granada,es La Liga,33,1988,14.8,26,13,16,7,3,17,27,63.0,10,11,1,10,11,37,29,1
Martín Montoya,es ESP,DF,Betis,es La Liga,30,1991,5.8,20,12,11,7,2,15,26,57.7,11,6,0,6,11,31,20,0
Wesley Moraes,br BRA,FW,Aston Villa,eng Premier League,24,1996,0,0,0,0,0,0,0,0,,0,0,0,0,0,0,0,0
Álvaro Morata,es ESP,FW,Juventus,it Serie A,28,1992,25.6,18,9,4,9,5,8,31,25.8,23,26,1,25,5,23,24,0
Jan Morávek,cz CZE,MF,Augsburg,de Bundesliga,31,1989,5.2,11,6,3,7,1,6,18,33.3,12,11,2,9,6,17,8,0
Jon Morcillo,es ESP,MFFW,Athletic Club,es La Liga,22,1998,0.6,3,0,1,2,0,3,4,75.0,1,1,0,1,0,3,0,0
Jérémy Morel,mg MAD,DF,Lorient,fr Ligue 1,37,1984,6.7,13,9,8,4,1,6,6,100.0,0,9,7,2,7,20,31,0
Alberto Moreno,es ESP,MFDF,Villarreal,es La Liga,29,1992,13.6,13,7,5,7,1,5,18,27.8,13,13,1,12,27,40,15,0
Álex Moreno,es ESP,DF,Betis,es La Liga,28,1993,26.7,76,40,53,15,8,33,60,55.0,27,28,6,22,34,110,82,1
Gerard Moreno,es ESP,FW,Villarreal,es La Liga,29,1992,13.2,5,2,2,2,1,1,7,14.3,6,6,1,5,6,11,14,0
Tete Morente,es ESP,MF,Elche,es La Liga,24,1996,18.1,21,14,13,7,1,7,28,25.0,21,30,1,29,12,33,12,0
Ilaix Moriba,gn GUI,MF,Valencia,es La Liga,18,2003,9.1,26,18,10,13,3,14,35,40.0,21,15,0,15,12,38,14,0
Ilaix Moriba,gn GUI,MF,RB Leipzig,de Bundesliga,18,2003,0.4,0,0,0,0,0,0,4,0.0,4,2,0,2,1,1,0,0
Manu Morlanes,es ESP,MF,Espanyol,es La Liga,22,1999,12.7,36,15,16,17,3,18,43,41.9,25,24,5,19,13,49,17,0
Raúl Moro,es ESP,FW,Lazio,it Serie A,18,2002,2.2,3,3,0,2,1,1,5,20.0,4,2,0,2,0,3,0,0
Loren Morón,es ESP,FWMF,Espanyol,es La Liga,27,1993,6.3,6,4,1,3,2,0,12,0.0,12,11,1,10,2,8,9,0
Loren Morón,es ESP,FW,Betis,es La Liga,27,1993,0,1,1,1,0,0,1,1,100.0,0,0,0,0,0,1,0,0
Tyler Morton,eng ENG,MF,Liverpool,eng Premier League,18,2002,0.7,0,0,0,0,0,0,2,0.0,2,0,0,0,3,3,0,0
Cristhian Mosquera,co COL,DF,Valencia,es La Liga,17,2004,2.4,4,2,3,0,1,3,6,50.0,3,1,0,1,3,7,1,1
Lebo Mothiba,za RSA,FWMF,Troyes,fr Ligue 1,25,1996,5.8,8,4,4,3,1,2,5,40.0,3,3,0,3,2,10,0,0
Lebo Mothiba,za RSA,FW,Strasbourg,fr Ligue 1,25,1996,0,0,0,0,0,0,0,0,,0,0,0,0,0,0,0,0
Andrei Motoc,ro ROU,DF,Salernitana,it Serie A,19,2002,1,1,1,0,1,0,0,0,,0,2,2,0,2,3,1,0
Baptiste Mouazan,fr FRA,MF,Lorient,fr Ligue 1,19,2001,1.1,4,3,2,2,0,1,3,33.3,2,3,0,3,1,5,1,0
Aimen Moueffek,fr FRA,MF,Saint-Étienne,fr Ligue 1,20,2001,4.8,7,4,2,3,2,2,8,25.0,6,3,0,3,2,9,4,0
Youssoufa Moukoko,de GER,FWMF,Dortmund,de Bundesliga,16,2004,2.5,1,0,0,1,0,0,1,0.0,1,5,0,5,3,4,0,0
Harold Moukoudi,cm CMR,DF,Saint-Étienne,fr Ligue 1,23,1997,18.5,25,12,17,8,0,14,25,56.0,11,27,14,13,35,60,48,0
Jessy Moulin,fr FRA,GK,Troyes,fr Ligue 1,35,1986,7,0,0,0,0,0,0,0,,0,0,0,0,1,1,7,0
Steve Mounié,bj BEN,FW,Brest,fr Ligue 1,26,1994,25.7,17,6,3,12,2,4,27,14.8,23,13,1,12,6,23,12,0
Mason Mount,eng ENG,MF,Chelsea,eng Premier League,22,1999,26.3,41,16,10,17,14,10,34,29.4,24,18,1,17,13,54,12,0
Lucas Moura,br BRA,FWMF,Tottenham,eng Premier League,28,1992,19.7,25,10,7,14,4,8,35,22.9,27,19,0,19,18,43,19,0
Lys Mousset,fr FRA,MFFW,Salernitana,it Serie A,25,1996,1.8,1,0,0,1,0,0,0,,0,2,0,2,0,1,0,0
João Moutinho,pt POR,MF,Wolves,eng Premier League,34,1986,33,74,39,34,27,13,30,106,28.3,76,48,8,40,34,108,36,2
Samuel Moutoussamy,cd COD,MF,Nantes,fr Ligue 1,24,1996,16.8,48,32,20,20,8,23,62,37.1,39,14,2,12,17,65,16,0
Toni Moya,es ESP,MF,Alavés,es La Liga,23,1998,15.4,23,10,7,13,3,13,43,30.2,30,18,5,13,20,43,18,0
Samuel Mráz,sk SVK,FW,Spezia,it Serie A,24,1997,0.6,0,0,0,0,0,0,0,,0,1,0,1,0,0,0,0
Nordi Mukiele,fr FRA,DFFW,RB Leipzig,de Bundesliga,23,1997,20.5,35,22,23,9,3,14,27,51.9,13,31,5,26,31,66,44,2
Mert Müldür,tr TUR,DF,Sassuolo,it Serie A,22,1999,22.7,52,35,43,7,2,27,49,55.1,22,25,6,19,24,76,44,1
Florian Müller,de GER,GK,Stuttgart,de Bundesliga,23,1997,30,0,0,0,0,0,0,1,0.0,1,1,0,1,0,0,13,2
Thomas Müller,de GER,MF,Bayern Munich,de Bundesliga,31,1989,28.4,35,20,7,16,12,16,54,29.6,38,32,1,31,15,50,12,0
Bali Mumba,eng ENG,DF,Norwich City,eng Premier League,19,2001,0.5,1,1,1,0,0,0,0,,0,0,0,0,0,1,5,0
Marshall Munetsi,zw ZIM,MFDF,Reims,fr Ligue 1,25,1996,20.9,34,17,21,11,2,17,39,43.6,22,39,13,26,43,77,72,2
Iker Muniain,es ESP,MF,Athletic Club,es La Liga,28,1992,30.9,32,10,8,19,5,12,40,30.0,28,20,1,19,17,49,8,1
Aihen Muñoz,es ESP,DF,Real Sociedad,es La Liga,23,1997,14.9,28,17,14,13,1,18,29,62.1,11,11,1,10,17,45,34,0
Luis Muriel,co COL,FWMF,Atalanta,it Serie A,30,1991,17.1,15,4,2,7,6,3,19,15.8,16,12,0,12,4,19,5,0
Jeison Murillo,co COL,DF,Celta Vigo,es La Liga,29,1992,12.4,15,10,13,2,0,9,13,69.2,4,11,8,3,17,32,37,0
Vedat Muriqi,xk KVX,FW,Lazio,it Serie A,27,1994,2.4,1,0,1,0,0,0,5,0.0,5,0,0,0,0,1,2,0
Vedat Muriqi,xk KVX,FW,Mallorca,es La Liga,27,1994,16,6,3,1,3,2,1,7,14.3,6,12,0,12,6,12,29,0
Jacob Murphy,eng ENG,FWDF,Newcastle Utd,eng Premier League,26,1995,16.4,49,26,34,11,4,26,41,63.4,15,20,2,18,23,72,17,0
Nicola Murru,it ITA,DF,Sampdoria,it Serie A,26,1994,10.9,22,17,10,11,1,8,13,61.5,5,17,3,14,7,29,20,1
Yunus Musah,us USA,MFFW,Valencia,es La Liga,18,2002,14,23,13,8,8,7,6,20,30.0,14,19,1,18,14,37,11,0
Torben Müsel,de GER,MF,M'Gladbach,de Bundesliga,22,1999,0.1,0,0,0,0,0,0,0,,0,0,0,0,0,0,0,0
Jamal Musiala,de GER,MFFW,Bayern Munich,de Bundesliga,18,2003,16.3,40,26,11,16,13,15,36,41.7,21,25,0,25,19,59,2,1
Juan Musso,ar ARG,GK,Atalanta,it Serie A,27,1994,32.6,1,1,1,0,0,0,0,,0,0,0,0,0,1,17,1
Shkodran Mustafi,de GER,DF,Levante,es La Liga,29,1992,7.3,9,6,6,3,0,5,9,55.6,4,6,3,3,15,24,40,0
Junior Mwanga,fr FRA,DF,Bordeaux,fr Ligue 1,18,2003,1,5,2,4,1,0,3,3,100.0,0,1,0,1,0,5,1,0
Enock Mwepu,zm ZAM,MF,Brighton,eng Premier League,23,1998,11.1,22,12,10,10,2,5,27,18.5,22,20,2,18,12,34,19,0
Vitaliy Mykolenko,ua UKR,DF,Everton,eng Premier League,22,1999,11.7,25,15,15,7,3,12,21,57.1,9,15,2,13,16,41,37,0
Joakim Mæhle,dk DEN,DFMF,Atalanta,it Serie A,24,1997,16.3,21,11,6,9,6,12,27,44.4,15,18,2,16,14,35,13,0
Obite N'Dicka,fr FRA,DF,Eint Frankfurt,de Bundesliga,21,1999,31.7,60,34,29,27,4,44,59,74.6,15,46,20,26,48,108,137,0
Kévin N'Doram,fr FRA,MF,Metz,fr Ligue 1,25,1996,13.7,10,8,3,5,2,3,20,15.0,17,24,5,19,19,29,21,0
Eric N'Jo,fr FRA,DF,Troyes,fr Ligue 1,17,2004,1.1,0,0,0,0,0,0,1,0.0,1,1,1,0,2,2,1,0
Vital N'Simba,cd COD,DF,Clermont Foot,fr Ligue 1,28,1993,31,66,45,38,23,5,36,63,57.1,27,28,7,21,29,95,30,0
Nacho,es ESP,DF,Real Madrid,es La Liga,31,1990,17.3,18,14,9,9,0,12,22,54.5,10,22,15,7,34,52,50,0
Mickael Nade,fr FRA,DF,Saint-Étienne,fr Ligue 1,22,1999,28.5,57,35,37,18,2,23,38,60.5,15,29,15,14,60,117,84,0
Marvelous Nakamba,zw ZIM,MF,Aston Villa,eng Premier League,27,1994,10,32,19,18,14,0,12,34,35.3,22,14,4,10,12,44,17,1
Nahitan Nández,uy URU,MFDF,Cagliari,it Serie A,25,1995,16.9,39,21,16,15,8,18,33,54.5,15,16,1,15,9,48,15,1
Nani,pt POR,MFFW,Venezia,it Serie A,34,1986,3.2,2,1,1,1,0,0,1,0.0,1,1,0,1,2,4,0,1
Paul Nardi,fr FRA,GK,Lorient,fr Ligue 1,27,1994,22,1,0,1,0,0,1,2,50.0,1,0,0,0,0,1,10,2
Nikolas Nartey,dk DEN,MFDF,Stuttgart,de Bundesliga,21,2000,4.5,6,3,0,5,1,3,9,33.3,6,4,2,2,7,13,5,0
Matija Nastasić,rs SRB,DF,Fiorentina,it Serie A,28,1993,2.4,1,1,1,0,0,1,1,100.0,0,1,1,0,5,6,11,0
Roberto Navarro,es ESP,MFFW,Real Sociedad,es La Liga,19,2002,2.2,5,3,1,1,3,3,5,60.0,2,2,0,2,2,7,2,0
Ximo Navarro,es ESP,DF,Alavés,es La Liga,31,1990,15,28,19,21,6,1,13,27,48.1,14,11,5,6,22,50,56,2
Jesús Navas,es ESP,DF,Sevilla,es La Liga,35,1985,19.8,18,13,11,5,2,9,18,50.0,9,15,2,13,17,35,26,1
Keylor Navas,cr CRC,GK,Paris S-G,fr Ligue 1,34,1986,20.6,0,0,0,0,0,0,0,,0,0,0,0,0,0,5,1
Papa Ndiaga Yade,sn SEN,DFFW,Metz,fr Ligue 1,21,2000,7.7,15,10,8,7,0,8,18,44.4,10,4,1,3,10,25,9,0
Wilfred Ndidi,ng NGA,MFDF,Leicester City,eng Premier League,24,1996,18,60,32,32,27,1,22,55,40.0,33,36,8,28,42,102,54,1
Tanguy Ndombele,fr FRA,MF,Tottenham,eng Premier League,24,1996,5.4,10,7,3,5,2,1,8,12.5,7,5,0,5,1,11,1,0
Tanguy Ndombele,fr FRA,MF,Lyon,fr Ligue 1,24,1996,7.8,25,14,5,17,3,12,19,63.2,7,8,3,5,3,28,6,2
Dan Ndoye,ch SUI,FWMF,Nice,fr Ligue 1,20,2000,2.3,0,0,0,0,0,0,2,0.0,2,4,0,4,0,0,0,0
Paul Nebel,de GER,MFFW,Mainz 05,de Bundesliga,18,2002,2.5,5,3,3,1,1,2,3,66.7,1,0,0,0,0,5,1,0
Álvaro Negredo,es ESP,FW,Cádiz,es La Liga,35,1985,24,5,3,1,4,0,3,6,50.0,3,11,5,6,2,7,23,0
Reiss Nelson,eng ENG,FW,Arsenal,eng Premier League,21,1999,0.2,1,0,0,0,1,0,1,0.0,1,1,0,1,0,1,0,0
David Nemeth,at AUT,DF,Mainz 05,de Bundesliga,20,2001,3.5,3,2,2,1,0,1,3,33.3,2,5,1,4,6,9,11,1
Ilija Nestorovski,mk MKD,FW,Udinese,it Serie A,31,1990,2.1,0,0,0,0,0,0,3,0.0,3,0,0,0,0,0,4,0
Neto,br BRA,GK,Barcelona,es La Liga,32,1989,3,0,0,0,0,0,0,0,,0,0,0,0,0,0,2,1
Pedro Neto,pt POR,FWMF,Wolves,eng Premier League,21,2000,5.2,4,4,2,0,2,0,9,0.0,9,0,0,0,6,10,1,0
Luca Netz,de GER,DFFW,M'Gladbach,de Bundesliga,18,2003,15.5,25,11,13,10,2,12,41,29.3,29,24,4,20,13,38,36,1
Manuel Neuer,de GER,GK,Bayern Munich,de Bundesliga,35,1986,27.9,2,1,2,0,0,1,2,50.0,1,0,0,0,0,2,7,1
Florian Neuhaus,de GER,MF,M'Gladbach,de Bundesliga,24,1997,23.6,55,28,24,26,5,27,65,41.5,38,38,6,32,31,86,25,4
Carlos Neva,es ESP,DF,Granada,es La Liga,25,1996,23.4,31,19,24,7,0,16,28,57.1,12,27,9,18,32,63,81,0
Rúben Neves,pt POR,MF,Wolves,eng Premier League,24,1997,29.6,68,37,23,41,4,24,87,27.6,63,39,5,34,41,109,49,3
Neymar,br BRA,FWMF,Paris S-G,fr Ligue 1,29,1992,20.6,29,19,5,12,12,12,36,33.3,24,9,1,8,4,33,2,1
Yvan Neyou,cm CMR,MF,Saint-Étienne,fr Ligue 1,24,1997,10.4,29,13,14,12,3,9,27,33.3,18,8,3,5,23,52,13,0
Jeremy Ngakia,eng ENG,DF,Watford,eng Premier League,20,2000,10,31,18,23,5,3,11,26,42.3,15,11,4,7,12,43,32,0
Jessic Ngankam,de GER,FW,Greuther Fürth,de Bundesliga,21,2000,3.8,3,1,1,1,1,1,2,50.0,1,3,0,3,0,3,1,0
Opa Nguette,sn SEN,FWMF,Metz,fr Ligue 1,27,1994,11.6,21,14,9,6,6,5,14,35.7,9,13,3,10,2,23,9,0
Aurélien Nguiamba,fr FRA,MF,Spezia,it Serie A,22,1999,0.6,3,2,1,2,0,2,3,66.7,1,2,1,1,0,3,1,0
Sikou Niakaté,fr FRA,DF,Metz,fr Ligue 1,22,1999,7.3,8,7,8,0,0,4,11,36.4,7,5,3,2,27,35,34,0
Moussa Niakhate,fr FRA,DF,Mainz 05,de Bundesliga,25,1996,28.5,40,23,25,13,2,20,33,60.6,13,37,11,26,50,90,69,1
Ibrahima Niane,sn SEN,FW,Metz,fr Ligue 1,22,1999,17.6,1,1,0,1,0,0,5,0.0,5,6,1,5,3,4,16,0
M'Baye Niang,sn SEN,FW,Bordeaux,fr Ligue 1,26,1994,8.6,4,0,0,2,2,0,4,0.0,4,9,1,8,1,5,4,0
Tanguy Nianzou,fr FRA,DF,Bayern Munich,de Bundesliga,19,2002,6.5,11,7,7,3,1,7,11,63.6,4,7,2,5,7,18,17,0
Cheikh Niasse,sn SEN,FWMF,Lille,fr Ligue 1,21,2000,0.5,2,2,0,2,0,2,3,66.7,1,1,1,0,1,3,2,0
Florian Niederlechner,de GER,FW,Augsburg,de Bundesliga,30,1990,12.9,6,5,1,3,2,4,13,30.8,9,9,0,9,4,10,7,0
Håvard Nielsen,no NOR,MFFW,Greuther Fürth,de Bundesliga,28,1993,15.2,17,12,5,11,1,8,21,38.1,13,18,1,17,7,24,22,0
Saúl Ñíguez,es ESP,DFMF,Chelsea,eng Premier League,26,1994,5.3,20,9,11,9,0,9,16,56.3,7,14,3,11,7,27,10,1
Saúl Ñíguez,es ESP,FWMF,Atlético Madrid,es La Liga,26,1994,2.2,7,2,0,6,1,3,4,75.0,1,7,1,6,0,7,3,0
Dimitris Nikolaou,gr GRE,DF,Spezia,it Serie A,22,1998,36,39,26,29,7,3,22,34,64.7,12,48,24,24,49,88,132,1
Joakim Nilsson,se SWE,DF,Arminia,de Bundesliga,27,1994,30.4,37,19,24,13,0,20,26,76.9,6,36,23,13,56,93,144,1
Casimir Ninga,td CHA,FW,Angers,fr Ligue 1,28,1993,4.5,5,1,1,4,0,2,5,40.0,3,2,0,2,1,6,0,0
Fernando Niño,es ESP,FW,Mallorca,es La Liga,20,2000,9.8,10,4,3,2,5,2,12,16.7,10,9,2,7,3,13,15,0
Eddie Nketiah,eng ENG,FW,Arsenal,eng Premier League,22,1999,9.3,9,4,1,4,4,1,4,25.0,3,9,2,7,4,13,5,0
Nicolas Nkoulou,cm CMR,DF,Watford,eng Premier League,31,1990,1.9,1,0,0,1,0,0,0,,0,2,1,1,2,3,8,0
Christopher Nkunku,fr FRA,FWMF,RB Leipzig,de Bundesliga,23,1997,30.3,23,10,10,11,2,9,35,25.7,26,23,2,21,15,38,15,0
Lukas Nmecha,de GER,FWMF,Wolfsburg,de Bundesliga,22,1998,18.1,12,5,5,5,2,5,19,26.3,14,9,1,8,4,16,10,0
Mark Noble,eng ENG,MF,West Ham,eng Premier League,34,1987,3.7,8,2,7,1,0,5,11,45.5,6,4,1,3,4,12,2,1
Peru Nolaskoain,es ESP,DF,Athletic Club,es La Liga,22,1998,0,0,0,0,0,0,0,0,,0,0,0,0,0,0,0,0
Nolito,es ESP,MF,Celta Vigo,es La Liga,34,1986,15.4,25,15,14,7,4,13,47,27.7,34,20,1,19,9,34,5,0
Arnaud Nordin,fr FRA,FWMF,Saint-Étienne,fr Ligue 1,23,1998,20.8,21,11,8,8,5,8,22,36.4,14,19,0,19,6,27,8,0
Håvard Nordtveit,no NOR,DF,Hoffenheim,de Bundesliga,31,1990,3.4,7,6,2,4,1,4,4,100.0,0,2,1,1,10,17,11,0
Mathias Normann,no NOR,MF,Norwich City,eng Premier League,25,1996,18.3,34,21,19,14,1,17,46,37.0,29,17,8,9,19,53,43,1
Connor Noß,ie IRL,MF,M'Gladbach,de Bundesliga,20,2001,0.6,1,0,0,1,0,0,1,0.0,1,1,1,0,0,1,0,0
Hugo Novoa,es ESP,MFFW,RB Leipzig,de Bundesliga,18,2003,1.5,4,4,2,0,2,2,7,28.6,5,2,0,2,1,5,0,0
Soma Novothny,hu HUN,FWMF,Bochum,de Bundesliga,27,1994,0.9,1,1,1,0,0,0,1,0.0,1,1,0,1,0,1,2,0
Jean-Pierre Nsame,cm CMR,FW,Venezia,it Serie A,28,1993,2.7,1,1,0,0,1,0,0,,0,0,0,0,0,1,1,0
Randy Ntekja,fr FRA,FWMF,Rayo Vallecano,es La Liga,23,1997,16.2,24,13,9,11,4,8,19,42.1,11,21,1,20,8,32,12,0
Alexander Nübel,de GER,GK,Monaco,fr Ligue 1,24,1996,38,0,0,0,0,0,0,0,,0,0,0,0,0,0,11,1
Kasim Nuhu,gh GHA,DF,Hoffenheim,de Bundesliga,26,1995,0.1,0,0,0,0,0,0,1,0.0,1,0,0,0,0,0,1,0
Unai Núñez,es ESP,DF,Athletic Club,es La Liga,24,1997,6.9,4,4,2,2,0,3,6,50.0,3,9,8,1,8,12,26,2
Hans Nunoo Sarpei,gh GHA,DFMF,Greuther Fürth,de Bundesliga,22,1998,7.1,16,11,9,7,0,10,14,71.4,4,8,5,3,14,30,21,0
Bram Nuytinck,nl NED,DF,Udinese,it Serie A,31,1990,22.6,38,24,24,13,1,15,34,44.1,19,42,31,11,22,60,101,0
Simeon Nwankwo,ng NGA,FW,Salernitana,it Serie A,29,1992,9.4,5,5,0,4,1,4,10,40.0,6,8,3,5,3,8,10,0
Gerzino Nyamsi,fr FRA,DF,Strasbourg,fr Ligue 1,24,1997,33.2,35,21,24,9,2,20,27,74.1,7,25,16,9,25,60,90,1
Allan Nyom,cm CMR,DF,Getafe,es La Liga,33,1988,2.7,3,1,2,1,0,2,2,100.0,0,2,1,1,2,5,7,0
M'Bala Nzola,ao ANG,FW,Spezia,it Serie A,24,1996,11.9,2,2,0,0,2,1,6,16.7,5,8,0,8,0,2,13,0
Christian Nørgaard,dk DEN,MF,Brentford,eng Premier League,27,1994,33.9,109,60,42,58,9,52,101,51.5,49,48,9,39,64,173,58,1
Adam Obert,sk SVK,DFMF,Cagliari,it Serie A,18,2002,3,8,5,6,2,0,5,6,83.3,1,6,4,2,4,12,11,0
Joel Obi,ng NGA,MFDF,Salernitana,it Serie A,30,1991,12.7,23,14,5,14,4,5,12,41.7,7,17,6,11,10,33,7,0
Jan Oblak,si SVN,GK,Atlético Madrid,es La Liga,28,1993,38,0,0,0,0,0,0,0,,0,0,0,0,1,1,10,4
Lucas Ocampos,ar ARG,FW,Sevilla,es La Liga,27,1994,23.6,45,24,23,18,4,23,55,41.8,32,35,1,34,9,54,24,1
Bastian Oczipka,de GER,DF,Union Berlin,de Bundesliga,32,1989,10.4,24,15,15,7,2,10,13,76.9,3,10,2,8,12,36,21,0
Brain Oddei,it ITA,FW,Sassuolo,it Serie A,18,2002,0.1,0,0,0,0,0,0,0,,0,0,0,0,0,0,0,0
Álvaro Odriozola,es ESP,DF,Fiorentina,it Serie A,25,1995,19.3,25,15,12,6,7,15,32,46.9,17,17,6,11,8,33,25,2
Angelo Ogbonna,it ITA,DF,West Ham,eng Premier League,33,1988,10.2,7,4,5,2,0,3,7,42.9,4,5,4,1,11,18,29,0
Florent Ogier,fr FRA,DF,Clermont Foot,fr Ligue 1,32,1989,27,31,17,18,12,1,17,31,54.8,14,41,27,14,37,68,89,0
Stefano Okaka,it ITA,FW,Udinese,it Serie A,31,1989,0.2,0,0,0,0,0,0,0,,0,2,0,2,0,0,1,0
David Okereke,ng NGA,FWMF,Venezia,it Serie A,23,1997,22.8,16,10,4,9,3,3,20,15.0,17,19,3,16,10,26,20,0
Masaya Okugawa,jp JPN,MFFW,Arminia,de Bundesliga,25,1996,28.1,46,25,18,22,6,12,37,32.4,25,29,1,28,20,66,13,0
Lucas Olaza,uy URU,DF,Elche,es La Liga,27,1994,3.3,5,3,3,1,1,1,1,100.0,0,5,1,4,4,9,6,0
Oier Olazábal,es ESP,GK,Espanyol,es La Liga,31,1989,1.5,0,0,0,0,0,0,0,,0,0,0,0,0,0,0,0
Mathias Olesen,lu LUX,MFFW,Köln,de Bundesliga,20,2001,0.2,0,0,0,0,0,0,0,,0,0,0,0,1,1,0,0
Michael Olise,fr FRA,FWMF,Crystal Palace,eng Premier League,19,2001,12.7,22,18,8,11,3,7,24,29.2,17,17,0,17,6,28,6,0
Christian Oliva,uy URU,MF,Cagliari,it Serie A,25,1996,0.5,2,2,2,0,0,1,4,25.0,3,0,0,0,0,2,0,0
Brian Oliván,es ESP,DF,Mallorca,es La Liga,27,1994,24.3,33,20,22,9,2,12,23,52.2,11,17,7,10,28,61,63,0
Sérgio Oliveira,pt POR,MF,Roma,it Serie A,29,1992,9.9,27,14,11,14,2,15,30,50.0,15,13,0,13,10,37,7,0
Mathías Olivera,uy URU,DF,Getafe,es La Liga,23,1997,31.1,79,47,39,34,6,40,69,58.0,29,45,4,41,55,134,67,1
Dani Olmo,es ESP,MFFW,RB Leipzig,de Bundesliga,23,1998,8.3,14,6,5,7,2,5,18,27.8,13,5,1,4,4,18,1,0
Robin Olsen,se SWE,GK,Aston Villa,eng Premier League,31,1990,1,0,0,0,0,0,0,0,,0,0,0,0,0,0,0,0
Warmed Omari,fr FRA,DF,Rennes,fr Ligue 1,21,2000,31.1,33,17,22,10,1,15,23,65.2,8,20,13,7,31,64,94,5
Jonas Omlin,ch SUI,GK,Montpellier,fr Ligue 1,27,1994,28.7,2,1,2,0,0,2,3,66.7,1,0,0,0,0,2,12,3
Andrew Omobamidele,ie IRL,DF,Norwich City,eng Premier League,19,2002,4.2,8,6,5,3,0,5,11,45.5,6,8,8,0,5,13,13,0
Amadou Onana,be BEL,MF,Lille,fr Ligue 1,19,2001,15.1,48,31,17,27,4,18,25,72.0,7,10,3,7,30,78,19,0
Jean Onana,cm CMR,MF,Bordeaux,fr Ligue 1,21,2000,20.4,70,49,33,33,4,35,86,40.7,51,37,5,32,36,106,23,1
Karim Onisiwo,at AUT,FW,Mainz 05,de Bundesliga,29,1992,26.2,18,10,4,6,8,7,22,31.8,15,27,2,25,7,25,8,0
Javier Ontiveros,es ESP,FWMF,Osasuna,es La Liga,23,1997,0.4,0,0,0,0,0,0,2,0.0,2,0,0,0,1,1,0,1
Tyler Onyango,eng ENG,MF,Everton,eng Premier League,18,2003,0.3,0,0,0,0,0,0,0,,0,0,0,0,0,0,1,0
Frank Onyeka,ng NGA,MF,Brentford,eng Premier League,23,1998,11.6,25,17,13,9,3,8,27,29.6,19,16,2,14,14,39,13,0
Willi Orban,hu HUN,DF,RB Leipzig,de Bundesliga,28,1992,29.4,32,22,20,11,1,13,25,52.0,12,40,24,16,44,76,123,2
Divock Origi,be BEL,FW,Liverpool,eng Premier League,26,1995,1.5,0,0,0,0,0,0,2,0.0,2,1,0,1,1,1,2,0
Riccardo Orsolini,it ITA,FWMF,Bologna,it Serie A,24,1997,19.8,22,14,10,11,1,13,29,44.8,16,9,4,5,5,27,14,0
Stefan Ortega,de GER,GK,Arminia,de Bundesliga,28,1992,33,1,0,1,0,0,1,2,50.0,1,2,0,2,0,1,5,1
Pedro Ortiz,es ESP,MF,Sevilla,es La Liga,20,2000,0.1,0,0,0,0,0,0,0,,0,0,0,0,0,0,1,0
Victor Osimhen,ng NGA,FW,Napoli,it Serie A,22,1998,22,10,5,1,2,7,2,6,33.3,4,16,3,13,3,13,17,0
Milutin Osmajić,me MNE,FWMF,Cádiz,es La Liga,22,1999,2.9,1,1,0,1,0,0,0,,0,0,0,0,1,2,3,0
David Ospina,co COL,GK,Napoli,it Serie A,32,1988,31,0,0,0,0,0,0,0,,0,0,0,0,1,1,11,1
Patrick Osterhage,de GER,MF,Bochum,de Bundesliga,21,2000,6.7,9,6,3,5,1,3,7,42.9,4,7,1,6,11,20,8,0
Tomáš Ostrák,cz CZE,MFFW,Köln,de Bundesliga,21,2000,0.3,1,0,0,0,1,1,3,33.3,2,0,0,0,1,2,0,0
Otávio,br BRA,MF,Bordeaux,fr Ligue 1,27,1994,12.7,36,23,13,21,2,16,39,41.0,23,9,3,6,18,54,11,0
Paulo Otávio,br BRA,DFMF,Wolfsburg,de Bundesliga,26,1994,4,14,10,7,4,3,8,15,53.3,7,11,6,5,4,18,9,0
Dango Ouattara,bf BFA,MFFW,Lorient,fr Ligue 1,19,2002,9,21,15,9,11,1,11,23,47.8,12,10,1,9,14,35,15,1
Remi Oudin,fr FRA,MFFW,Bordeaux,fr Ligue 1,24,1996,19.3,34,18,19,13,2,18,32,56.3,14,14,3,11,27,61,21,0
Alexandre Oukidja,dz ALG,GK,Metz,fr Ligue 1,33,1988,20.8,0,0,0,0,0,0,1,0.0,1,1,0,1,1,1,17,2
Azzedine Ounahi,ma MAR,MF,Angers,fr Ligue 1,21,2000,18.1,39,22,16,22,1,11,40,27.5,29,19,1,18,26,65,13,0
Adam Ounas,dz ALG,MFFW,Napoli,it Serie A,24,1996,3.6,6,1,0,3,3,3,7,42.9,4,3,0,3,2,8,3,0
Jesús Owono,gq EQG,GK,Alavés,es La Liga,20,2001,1,0,0,0,0,0,0,0,,0,0,0,0,0,0,1,0
Reece Oxford,eng ENG,DF,Augsburg,de Bundesliga,22,1998,29.9,27,14,16,9,2,15,31,48.4,16,42,33,9,72,99,172,1
Alex Oxlade-Chamberlain,eng ENG,MFFW,Liverpool,eng Premier League,27,1993,8.7,15,11,2,8,5,3,14,21.4,11,12,2,10,6,21,5,0
Mikel Oyarzabal,es ESP,FWMF,Real Sociedad,es La Liga,24,1997,18.6,18,10,7,7,4,7,21,33.3,14,18,2,16,10,28,16,1
Ambroise Oyongo,cm CMR,DF,Montpellier,fr Ligue 1,30,1991,7.3,13,4,7,4,2,9,15,60.0,6,5,1,4,6,19,17,0
Salih Özcan,tr TUR,MF,Köln,de Bundesliga,23,1998,25.7,42,30,14,23,5,22,51,43.1,29,37,5,32,51,93,35,1
Levin Öztunalı,de GER,MF,Union Berlin,de Bundesliga,25,1996,6.4,14,11,6,5,3,7,17,41.2,10,3,0,3,4,18,12,0
Fernando Pacheco,es ESP,GK,Alavés,es La Liga,29,1992,33.9,2,1,2,0,0,2,2,100.0,0,0,0,0,0,2,18,1
Jon Pacheco,es ESP,DF,Real Sociedad,es La Liga,20,2001,4.2,6,4,4,2,0,3,3,100.0,0,6,4,2,6,12,18,0
Gonçalo Paciência,pt POR,FW,Eint Frankfurt,de Bundesliga,26,1994,5.7,4,2,2,1,1,1,3,33.3,2,2,0,2,1,5,4,0
Daniele Padelli,it ITA,GK,Udinese,it Serie A,35,1985,3,0,0,0,0,0,0,0,,0,0,0,0,0,0,2,1
Simone Pafundi,it ITA,FW,Udinese,it Serie A,15,2006,0.3,0,0,0,0,0,0,1,0.0,1,0,0,0,0,0,0,0
Vincent Pajot,fr FRA,MF,Metz,fr Ligue 1,30,1990,25.7,86,56,35,47,4,20,46,43.5,26,33,6,27,51,137,38,0
Exequiel Palacios,ar ARG,MF,Leverkusen,de Bundesliga,22,1998,12.2,30,19,12,14,4,15,38,39.5,23,20,1,19,28,58,11,2
Helibelton Palacios,co COL,DF,Elche,es La Liga,28,1993,21.5,69,38,56,10,3,37,55,67.3,18,21,8,13,18,87,61,0
Isaac Palazón Camacho,es ESP,FWMF,Rayo Vallecano,es La Liga,26,1994,25.4,42,28,20,19,3,18,59,30.5,41,31,3,28,13,55,22,0
Nicolas Pallois,fr FRA,DF,Nantes,fr Ligue 1,33,1987,27.2,51,33,40,11,0,34,59,57.6,25,40,19,21,53,104,116,1
Cole Palmer,eng ENG,FWMF,Manchester City,eng Premier League,19,2002,1.4,2,1,1,1,0,0,2,0.0,2,3,0,3,1,3,0,0
Erik Palmer-Brown,us USA,DF,Troyes,fr Ligue 1,24,1997,19.3,37,22,29,8,0,20,26,76.9,6,26,18,8,34,71,87,1
Emerson Palmieri,it ITA,DF,Chelsea,eng Premier League,26,1994,0.1,0,0,0,0,0,0,0,,0,0,0,0,0,0,0,0
Emerson Palmieri,it ITA,DF,Lyon,fr Ligue 1,26,1994,25.2,46,25,16,22,8,22,34,64.7,12,23,8,15,27,73,66,0
Martin Palumbo,no NOR,FW,Juventus,it Serie A,19,2002,0.1,0,0,0,0,0,0,1,0.0,1,0,0,0,0,0,0,0
Goran Pandev,mk MKD,FWMF,Genoa,it Serie A,38,1983,9.4,2,0,1,0,1,0,9,0.0,9,3,1,2,2,4,0,0
Ivor Pandur,hr CRO,GK,Hellas Verona,it Serie A,21,2000,3,0,0,0,0,0,0,0,,0,0,0,0,0,0,2,0
Miloš Pantović,rs SRB,MFFW,Bochum,de Bundesliga,25,1996,17,19,10,8,7,4,6,25,24.0,19,26,4,22,18,37,14,0
Antonios Papadopoulos,de GER,DFMF,Dortmund,de Bundesliga,21,1999,0.2,0,0,0,0,0,0,0,,0,1,0,1,0,0,0,0
Matondo-Merveille Papela,de GER,MF,Mainz 05,de Bundesliga,20,2001,0.9,3,2,2,1,0,2,3,66.7,1,2,0,2,2,5,0,0
Lucas Paquetá,br BRA,MFFW,Lyon,fr Ligue 1,23,1997,30,68,38,24,26,18,17,51,33.3,34,43,5,38,9,77,22,0
Rubén Pardo,es ESP,MF,Bordeaux,fr Ligue 1,28,1992,0.1,0,0,0,0,0,0,0,,0,0,0,0,0,0,0,0
Kevin Paredes,us USA,FWDF,Wolfsburg,de Bundesliga,18,2003,0.2,1,0,0,0,1,0,0,,0,1,0,1,0,1,0,0
Leandro Paredes,ar ARG,MF,Paris S-G,fr Ligue 1,27,1994,9.3,23,13,9,11,3,12,24,50.0,12,10,6,4,10,33,5,2
Daniel Parejo,es ESP,MF,Villarreal,es La Liga,32,1989,30,43,29,15,15,13,20,52,38.5,32,32,7,25,29,72,19,1
Fabiano Parisi,it ITA,DF,Empoli,it Serie A,20,2000,16.4,35,19,25,5,5,13,31,41.9,18,30,10,20,22,57,42,0
Raúl Parra,es ESP,DF,Cádiz,es La Liga,21,1999,1,2,1,2,0,0,1,3,33.3,2,0,0,0,0,2,5,0
Thomas Partey,gh GHA,MF,Arsenal,eng Premier League,28,1993,22.5,43,29,22,17,4,18,44,40.9,26,22,4,18,23,66,35,2
Mario Pašalić,hr CRO,MFFW,Atalanta,it Serie A,26,1995,22.2,27,12,8,13,6,12,30,40.0,18,27,6,21,20,47,14,0
Felix Passlack,de GER,DF,Dortmund,de Bundesliga,23,1998,5.2,13,9,8,4,1,6,12,50.0,6,5,1,4,4,17,7,0
Javier Pastore,ar ARG,MFFW,Elche,es La Liga,32,1989,5.8,7,3,3,2,2,3,12,25.0,9,5,1,4,4,11,2,0
Patric,es ESP,DF,Lazio,it Serie A,28,1993,18.3,21,15,17,4,0,9,20,45.0,11,22,11,11,12,33,44,2
Rui Patrício,pt POR,GK,Roma,it Serie A,33,1988,38,0,0,0,0,0,0,0,,0,1,0,1,0,0,10,3
Paulinho,br BRA,FWMF,Leverkusen,de Bundesliga,21,2000,13.5,22,13,6,13,3,13,27,48.1,14,14,1,13,6,28,7,0
Gabriel Paulista,br BRA,DF,Valencia,es La Liga,30,1990,17.7,21,12,16,5,0,14,20,70.0,6,18,12,6,39,60,88,0
Benjamin Pavard,fr FRA,DF,Bayern Munich,de Bundesliga,25,1996,23.1,35,20,21,13,1,19,29,65.5,10,28,16,12,36,71,50,1
Strahinja Pavlović,rs SRB,DF,Monaco,fr Ligue 1,20,2001,5,23,16,8,13,2,8,12,66.7,4,5,3,2,9,32,15,0
Leonardo Pavoletti,it ITA,FW,Cagliari,it Serie A,32,1988,16.9,10,6,2,5,3,3,9,33.3,6,9,5,4,2,12,12,0
Dimitri Payet,fr FRA,FWMF,Marseille,fr Ligue 1,34,1987,28.8,16,8,4,10,2,7,31,22.6,24,9,0,9,9,25,3,0
Mads Pedersen,dk DEN,MFDF,Augsburg,de Bundesliga,24,1996,15.5,28,21,8,15,5,12,27,44.4,15,13,4,9,15,43,30,0
Alfonso Pedraza,es ESP,DF,Villarreal,es La Liga,25,1996,18.9,34,16,17,12,5,10,28,35.7,18,12,3,9,31,65,32,0
Pedri,es ESP,MF,Barcelona,es La Liga,18,2002,9.8,20,12,9,8,3,7,20,35.0,13,13,0,13,5,25,7,1
Pedro,es ESP,FW,Lazio,it Serie A,34,1987,22.6,36,23,8,19,9,16,47,34.0,31,18,2,16,6,42,8,0
João Pedro,it ITA,FW,Cagliari,it Serie A,29,1992,36.9,15,12,2,8,5,4,18,22.2,14,23,5,18,8,23,18,1
Pedrosa,es ESP,DF,Espanyol,es La Liga,23,1998,30.2,58,30,38,14,6,26,57,45.6,31,25,7,18,25,83,92,2
Gianluca Pegolo,it ITA,GK,Sassuolo,it Serie A,40,1981,1,0,0,0,0,0,0,0,,0,0,0,0,0,0,0,1
Peter Pekarík,sk SVK,DF,Hertha BSC,de Bundesliga,34,1986,24.8,45,29,33,11,1,32,46,69.6,14,28,10,18,29,74,58,0
Pietro Pellegri,it ITA,FW,Torino,it Serie A,20,2001,2.4,1,1,0,1,0,0,4,0.0,4,0,0,0,0,1,5,0
Pietro Pellegri,it ITA,FW,Milan,it Serie A,20,2001,1.5,2,2,0,1,1,0,1,0.0,1,0,0,0,0,2,1,0
Lorenzo Pellegrini,it ITA,MF,Roma,it Serie A,25,1996,25.4,35,14,10,17,8,16,60,26.7,44,29,1,28,27,62,20,0
Luca Pellegrini,it ITA,DF,Juventus,it Serie A,22,1999,12.3,23,10,13,5,5,12,19,63.2,7,9,1,8,5,28,23,0
Facundo Pellistri,uy URU,MFFW,Alavés,es La Liga,19,2001,7.5,9,5,4,3,2,1,10,10.0,9,13,2,11,6,15,7,0
Federico Peluso,it ITA,DF,Sassuolo,it Serie A,37,1984,0.1,1,1,0,1,0,1,1,100.0,0,0,0,0,0,1,0,0
Timothee Pembele,fr FRA,DF,Bordeaux,fr Ligue 1,18,2002,15.7,20,8,8,10,2,10,29,34.5,19,12,3,9,16,36,24,0
Rubén Peña,es ESP,MFFW,Villarreal,es La Liga,30,1991,1.5,2,0,1,1,0,2,6,33.3,4,1,0,1,5,7,2,0
Philipp Pentke,de GER,GK,Hoffenheim,de Bundesliga,36,1985,1,0,0,0,0,0,0,0,,0,0,0,0,0,0,0,0
Nicolas Pépé,ci CIV,FWMF,Arsenal,eng Premier League,26,1995,7.7,8,5,3,5,0,3,9,33.3,6,9,1,8,8,16,2,0
Ricardo Pepi,us USA,FWMF,Augsburg,de Bundesliga,18,2003,5.3,4,2,1,3,0,1,8,12.5,7,7,0,7,3,7,8,0
Alberto Perea,es ESP,MF,Cádiz,es La Liga,30,1990,8.6,19,9,7,9,3,6,20,30.0,14,15,1,14,9,28,4,0
Victor Perea,es ESP,DF,Espanyol,es La Liga,21,2000,0,0,0,0,0,0,0,0,,0,0,0,0,0,0,0,0
Brayann Pereira,fr FRA,DFMF,Lens,fr Ligue 1,18,2003,0.2,1,1,1,0,0,1,1,100.0,0,0,0,0,0,1,1,0
Danilo Pereira,pt POR,MF,Paris S-G,fr Ligue 1,29,1991,22.6,33,17,10,20,3,14,28,50.0,14,19,10,9,37,70,29,1
Mathias Pereira Lage,pt POR,DF,Angers,fr Ligue 1,24,1996,11.6,21,7,10,7,4,8,30,26.7,22,18,7,11,21,42,22,0
Ricardo Pereira,pt POR,DF,Leicester City,eng Premier League,27,1993,11,37,20,19,13,5,21,40,52.5,19,13,1,12,17,54,39,0
Gastón Pereiro,uy URU,FWMF,Cagliari,it Serie A,26,1995,10.8,13,5,7,4,2,5,18,27.8,13,12,1,11,1,14,8,0
Luan Peres Petroni,br BRA,DF,Marseille,fr Ligue 1,27,1994,29.8,65,35,33,25,7,36,52,69.2,16,26,12,14,43,108,64,1
Dor Peretz,il ISR,MF,Venezia,it Serie A,26,1995,6.5,27,18,8,16,3,13,25,52.0,12,8,4,4,8,35,11,0
Roberto Pereyra,ar ARG,MFFW,Udinese,it Serie A,30,1991,19.9,18,12,7,6,5,7,23,30.4,16,26,5,21,12,30,11,0
Ayoze Pérez,es ESP,MFFW,Leicester City,eng Premier League,28,1993,4.9,4,2,0,3,1,0,13,0.0,13,11,1,10,2,6,5,0
Carles Pérez,es ESP,MFFW,Roma,it Serie A,23,1998,6.2,8,3,3,1,4,3,12,25.0,9,10,0,10,2,10,2,0
Iñigo Pérez,es ESP,MF,Osasuna,es La Liga,33,1988,3.8,3,2,2,1,0,2,4,50.0,2,1,0,1,0,3,3,0
Juan Pérez,es ESP,GK,Osasuna,es La Liga,25,1996,2,0,0,0,0,0,0,1,0.0,1,0,0,0,0,0,1,1
Kike Pérez,es ESP,MFFW,Elche,es La Liga,24,1997,5.8,8,6,1,3,4,0,10,0.0,10,6,1,5,3,11,4,0
Lucas Pérez,es ESP,FW,Elche,es La Liga,32,1988,14.1,4,1,2,1,1,3,10,30.0,7,2,0,2,3,7,4,0
Lucas Pérez,es ESP,FWMF,Cádiz,es La Liga,32,1988,11.8,3,3,2,1,0,0,10,0.0,10,3,1,2,0,3,1,0
Nehuén Pérez,ar ARG,DF,Udinese,it Serie A,21,2000,18.8,44,21,21,21,2,16,25,64.0,9,27,9,18,21,65,47,0
Mattia Perin,it ITA,GK,Juventus,it Serie A,28,1992,4.5,0,0,0,0,0,0,0,,0,0,0,0,0,0,3,0
Ivan Perišić,hr CRO,DF,Inter,it Serie A,32,1989,31.3,38,22,18,11,9,28,50,56.0,22,39,7,32,47,85,42,0
Sonny Perkins,eng ENG,FW,West Ham,eng Premier League,17,2004,0,,0,,,,,,,,,,,0,,,
Diego Perotti,ar ARG,MFFW,Salernitana,it Serie A,33,1988,3.2,11,5,7,1,3,4,13,30.8,9,1,0,1,2,13,6,0
Romain Perraud,fr FRA,DF,Southampton,eng Premier League,23,1997,18,34,22,18,14,2,16,29,55.2,13,24,6,18,17,51,42,0
Lucas Perrin,fr FRA,DF,Strasbourg,fr Ligue 1,22,1998,27.8,43,32,24,17,2,26,45,57.8,19,28,11,17,42,85,67,0
Mario Perrone,it ITA,DF,Salernitana,it Serie A,18,2003,0.2,0,0,0,0,0,0,0,,0,0,0,0,0,0,0,0
Pavao Pervan,at AUT,GK,Wolfsburg,de Bundesliga,33,1987,6,0,0,0,0,0,0,0,,0,0,0,0,0,0,3,0
Matteo Pessina,it ITA,MFFW,Atalanta,it Serie A,24,1997,16,27,14,10,11,6,14,33,42.4,19,22,3,19,13,40,7,0
Andrea Petagna,it ITA,FW,Napoli,it Serie A,26,1995,6.5,3,3,0,3,0,1,4,25.0,3,1,0,1,0,3,5,0
Nils Petersen,de GER,FW,Freiburg,de Bundesliga,32,1988,6.4,5,3,2,3,0,1,13,7.7,12,7,0,7,2,7,17,0
Danijel Petković,me MNE,GK,Angers,fr Ligue 1,28,1993,15,0,0,0,0,0,0,1,0.0,1,0,0,0,1,1,9,5
Léo Pétrot,fr FRA,DF,Lorient,fr Ligue 1,24,1997,20.2,31,17,23,8,0,21,29,72.4,8,33,17,16,22,53,86,0
Njegoš Petrović,rs SRB,MF,Granada,es La Liga,22,1999,10.2,24,11,4,19,1,8,14,57.1,6,16,4,12,9,33,11,0
Jens Petter Hauge,no NOR,MFFW,Eint Frankfurt,de Bundesliga,21,1999,11.6,14,5,6,7,1,7,23,30.4,16,7,0,7,3,17,5,0
Alex Petxa,es ESP,DFMF,Athletic Club,es La Liga,24,1997,4.6,12,9,4,7,1,4,8,50.0,4,8,2,6,4,16,6,0
Germán Pezzella,ar ARG,DF,Betis,es La Liga,30,1991,22.1,21,9,16,5,0,16,29,55.2,13,29,18,11,39,60,106,0
Giuseppe Pezzella,it ITA,DFMF,Atalanta,it Serie A,23,1997,11.9,28,13,15,7,6,8,18,44.4,10,13,5,8,9,37,16,0
Immanuel Pherai,nl NED,MF,Dortmund,de Bundesliga,20,2001,0,0,0,0,0,0,0,0,,0,0,0,0,0,0,0,0
Maximilian Philipp,de GER,MF,Wolfsburg,de Bundesliga,27,1994,10.7,15,11,6,7,2,5,21,23.8,16,12,1,11,4,19,5,0
Romain Philippoteaux,fr FRA,MF,Brest,fr Ligue 1,33,1988,0.3,1,1,0,1,0,0,0,,0,0,0,0,0,1,0,0
Kalvin Phillips,eng ENG,MF,Leeds United,eng Premier League,25,1995,17.7,54,25,24,25,5,24,57,42.1,33,37,9,28,24,78,18,0
Jaden Philogene Bidace,eng ENG,FW,Aston Villa,eng Premier League,19,2002,0.1,0,0,0,0,0,0,0,,0,0,0,0,0,0,0,0
Jérôme Phojo,fr FRA,DF,Clermont Foot,fr Ligue 1,28,1993,0.1,0,0,0,0,0,0,0,,0,0,0,0,0,0,1,0
Krzysztof Piątek,pl POL,FW,Fiorentina,it Serie A,26,1995,8.1,5,4,1,1,3,2,3,66.7,1,6,0,6,2,7,8,0
Krzysztof Piątek,pl POL,FW,Hertha BSC,de Bundesliga,26,1995,3.9,2,2,0,1,1,0,1,0.0,1,0,0,0,0,2,6,0
Pablo Piatti,ar ARG,MFFW,Elche,es La Liga,32,1989,3.5,9,4,5,3,1,3,8,37.5,5,5,1,4,2,11,3,0
Cristiano Piccini,it ITA,DF,Valencia,es La Liga,28,1992,3.6,14,8,9,5,0,5,7,71.4,2,3,2,1,1,15,11,0
Roberto Piccoli,it ITA,FW,Genoa,it Serie A,20,2001,2.4,1,1,0,1,0,0,0,,0,0,0,0,1,2,1,1
Roberto Piccoli,it ITA,FW,Atalanta,it Serie A,20,2001,2.2,2,0,0,0,2,0,2,0.0,2,1,0,1,0,2,0,0
Jordan Pickford,eng ENG,GK,Everton,eng Premier League,27,1994,35,1,1,1,0,0,0,1,0.0,1,1,0,1,1,2,14,1
Jérémy Pied,fr FRA,DFFW,Lille,fr Ligue 1,32,1989,0.1,0,0,0,0,0,0,0,,0,0,0,0,1,1,0,0
Amos Pieper,de GER,DF,Arminia,de Bundesliga,23,1998,26.4,58,29,38,19,1,32,51,62.7,19,37,23,14,50,108,132,1
Ronaël Pierre-Gabriel,fr FRA,DF,Brest,fr Ligue 1,23,1998,28.3,79,45,52,21,6,42,73,57.5,31,22,7,15,48,127,74,0
Erik Pieters,nl NED,DF,Burnley,eng Premier League,32,1988,8.1,28,15,15,11,2,17,28,60.7,11,18,7,11,10,38,38,0
Tomás Pina Isla,es ESP,MF,Alavés,es La Liga,33,1987,16,28,16,13,11,4,14,29,48.3,15,12,3,9,22,50,23,0
Andrea Pinamonti,it ITA,FW,Empoli,it Serie A,22,1999,31.9,11,6,0,7,4,2,18,11.1,16,24,3,21,7,18,23,0
Orbelín Pineda,mx MEX,MFFW,Celta Vigo,es La Liga,25,1996,1.1,4,1,4,0,0,1,2,50.0,1,0,0,0,0,4,1,0
Ethan Pinnock,jm JAM,DF,Brentford,eng Premier League,28,1993,29.9,51,35,37,12,2,25,38,65.8,13,30,11,19,44,95,154,1
Yeremi Pino,es ESP,MFFW,Villarreal,es La Liga,18,2002,18.6,32,14,14,8,10,10,24,41.7,14,33,4,29,6,38,12,1
Carlo Pinsoglio,it ITA,GK,Juventus,it Serie A,31,1990,0.5,0,0,0,0,0,0,0,,0,0,0,0,0,0,0,0
Riccardo Pinzi,it ITA,FW,Udinese,it Serie A,17,2003,0,0,0,0,0,0,0,0,,0,0,0,0,0,0,0,0
Gerard Piqué,es ESP,DF,Barcelona,es La Liga,34,1987,23.2,22,12,18,4,0,11,14,78.6,3,19,16,3,34,56,86,1
Marko Pjaca,hr CRO,MF,Torino,it Serie A,26,1995,12.8,7,4,1,4,2,3,8,37.5,5,10,2,8,4,11,2,0
Marvin Plattenhardt,de GER,DF,Hertha BSC,de Bundesliga,29,1992,18.2,25,11,18,6,1,15,27,55.6,12,18,3,15,17,42,52,0
Alassane Pléa,fr FRA,MFFW,M'Gladbach,de Bundesliga,28,1993,23,18,14,6,9,3,7,20,35.0,13,9,1,8,4,22,10,0
Tommaso Pobega,it ITA,MF,Torino,it Serie A,22,1999,24.9,48,30,17,20,11,21,40,52.5,19,32,3,29,25,73,38,0
Daniel Podence,pt POR,FWMF,Wolves,eng Premier League,25,1995,16.5,18,11,10,5,3,4,17,23.5,13,8,1,7,10,28,1,0
Suf Podgoreanu,il ISR,FW,Spezia,it Serie A,19,2002,1.3,2,0,1,1,0,1,4,25.0,3,2,0,2,1,3,3,0
Paul Pogba,fr FRA,MFFW,Manchester Utd,eng Premier League,28,1993,15,13,9,5,7,1,6,28,21.4,22,11,0,11,13,26,16,0
Joel Pohjanpalo,fi FIN,FW,Leverkusen,de Bundesliga,26,1994,0.1,0,0,0,0,0,0,0,,0,0,0,0,0,0,0,0
Matteo Politano,it ITA,FW,Napoli,it Serie A,27,1993,18.3,24,12,8,11,5,15,54,27.8,39,11,2,9,13,37,5,0
Julian Pollersbeck,de GER,GK,Lyon,fr Ligue 1,26,1994,4.8,0,0,0,0,0,0,0,,0,0,0,0,1,1,1,0
Sebastian Polter,de GER,FW,Bochum,de Bundesliga,30,1991,26,9,3,1,4,4,2,11,18.2,9,15,5,10,2,11,24,0
Ezequiel Ponce,ar ARG,FW,Elche,es La Liga,24,1997,7.4,5,4,1,3,1,3,10,30.0,7,5,0,5,1,6,7,0
Marin Pongračić,hr CRO,DF,Dortmund,de Bundesliga,23,1997,9.2,17,10,13,4,0,6,10,60.0,4,11,5,6,17,34,32,2
Pere Pons,es ESP,MF,Alavés,es La Liga,28,1993,15.2,26,18,4,20,2,7,21,33.3,14,10,1,9,6,32,11,0
Nick Pope,eng ENG,GK,Burnley,eng Premier League,29,1992,36,0,0,0,0,0,0,2,0.0,2,0,0,0,2,2,30,3
Manolo Portanova,it ITA,FWMF,Genoa,it Serie A,21,2000,14.7,46,28,9,26,11,14,34,41.2,20,26,2,24,17,63,22,0
Portu,es ESP,FWMF,Real Sociedad,es La Liga,29,1992,17.7,16,7,2,6,8,3,19,15.8,16,21,3,18,7,23,8,0
Stefan Posch,at AUT,DF,Hoffenheim,de Bundesliga,24,1997,24.4,48,30,20,26,2,22,39,56.4,17,43,18,25,28,76,71,2
Sergio Postigo,es ESP,DF,Levante,es La Liga,32,1988,9.4,11,7,8,2,1,4,8,50.0,4,7,5,2,7,18,45,1
Yussuf Poulsen,dk DEN,FWMF,RB Leipzig,de Bundesliga,27,1994,12,13,4,3,6,4,3,13,23.1,10,13,0,13,3,16,9,0
Gaëtan Poussin,fr FRA,GK,Bordeaux,fr Ligue 1,22,1999,13,1,1,1,0,0,1,1,100.0,0,0,0,0,0,1,15,1
Darío Poveda,es ESP,FWMF,Getafe,es La Liga,24,1997,4.2,2,0,1,0,1,0,5,0.0,5,7,1,6,1,3,1,0
José Pozo,es ESP,MFDF,Rayo Vallecano,es La Liga,25,1996,0.8,2,2,0,2,0,2,3,66.7,1,1,0,1,0,2,1,0
Dennis Praet,be BEL,MF,Torino,it Serie A,27,1994,17.1,19,10,6,8,5,8,22,36.4,14,12,1,11,3,22,4,0
Mateusz Praszelik,pl POL,MF,Hellas Verona,it Serie A,20,2000,0.3,0,0,0,0,0,0,0,,0,0,0,0,0,0,0,0
Abdón Prats,es ESP,FW,Mallorca,es La Liga,28,1992,7.1,2,2,1,0,1,1,5,20.0,4,5,0,5,1,3,6,0
Sanjin Prcić,ba BIH,MF,Strasbourg,fr Ligue 1,27,1993,24.3,47,28,14,27,6,14,29,48.3,15,18,3,15,47,94,19,0
Nicolas de Préville,fr FRA,FWMF,Metz,fr Ligue 1,30,1991,21.9,17,8,7,8,2,3,19,15.8,16,12,4,8,5,22,11,0
Isaac Price,nir NIR,MF,Everton,eng Premier League,17,2003,0.2,0,0,0,0,0,0,0,,0,1,0,1,0,0,0,0
Manuel Prietl,at AUT,MF,Arminia,de Bundesliga,29,1991,23.6,59,26,23,31,5,23,60,38.3,37,28,3,25,39,98,33,0
Alejandro Primo,es ESP,GK,Levante,es La Liga,17,2004,1,0,0,0,0,0,0,0,,0,0,0,0,0,0,0,0
Grischa Prömel,de GER,MF,Union Berlin,de Bundesliga,26,1995,26.9,36,22,14,17,5,22,52,42.3,30,18,3,15,23,59,22,0
Nick Proschwitz,de GER,FW,Hoffenheim,de Bundesliga,34,1986,0.3,0,0,0,0,0,0,0,,0,0,0,0,0,0,0,0
Ivan Provedel,it ITA,GK,Spezia,it Serie A,27,1994,30.7,0,0,0,0,0,0,1,0.0,1,0,0,0,2,2,10,2
Javi Puado,es ESP,MFFW,Espanyol,es La Liga,23,1998,24.9,24,14,18,5,1,12,37,32.4,25,18,2,16,11,35,24,0
Pubill,es ESP,DFMF,Levante,es La Liga,18,2003,5.7,12,6,10,2,0,4,8,50.0,4,7,2,5,4,16,8,2
Antonio Puertas,es ESP,MFFW,Granada,es La Liga,29,1992,25.1,34,20,18,12,4,17,44,38.6,27,33,3,30,11,45,36,0
Riqui Puig,es ESP,MF,Barcelona,es La Liga,21,1999,5.4,6,3,2,4,0,2,14,14.3,12,5,0,5,3,9,0,0
Teemu Pukki,fi FIN,FW,Norwich City,eng Premier League,31,1990,36.1,23,11,2,14,7,6,29,20.7,23,21,1,20,4,27,3,0
Erick Pulgar,cl CHI,MF,Fiorentina,it Serie A,27,1994,3.8,6,6,4,2,0,4,9,44.4,5,5,1,4,5,11,2,1
Christian Pulisic,us USA,MFFW,Chelsea,eng Premier League,22,1998,14.3,10,7,6,3,1,3,17,17.6,14,12,0,12,5,15,10,0
Afimico Pululu,fr FRA,FWMF,Greuther Fürth,de Bundesliga,22,1999,0.8,1,0,1,0,0,1,2,50.0,1,1,0,1,0,1,0,0
Ignacio Pussetto,ar ARG,FWMF,Udinese,it Serie A,25,1995,13.4,17,9,2,9,6,2,10,20.0,8,18,2,16,4,21,13,0
Niklas Pyyhtiä,fi FIN,MF,Bologna,it Serie A,17,2003,0.2,0,0,0,0,0,0,1,0.0,1,0,0,0,0,0,0,0
Przemysław Płacheta,pl POL,FWMF,Norwich City,eng Premier League,23,1998,5.6,4,3,3,1,0,2,7,28.6,5,3,1,2,2,6,5,1
Yacine Qasmi,ma MAR,FW,Rayo Vallecano,es La Liga,30,1991,0,0,0,0,0,0,0,0,,0,0,0,0,0,0,0,0
Fabio Quagliarella,it ITA,FW,Sampdoria,it Serie A,38,1983,18.5,6,2,2,2,2,2,15,13.3,13,14,1,13,3,9,12,0
Quini,es ESP,DF,Granada,es La Liga,31,1989,25.6,73,34,48,21,4,42,79,53.2,37,28,10,18,36,109,62,0
Dani Raba,es ESP,MFFW,Villarreal,es La Liga,25,1995,1,1,0,0,1,0,1,2,50.0,1,2,0,2,0,1,2,0
Dani Raba,es ESP,MFFW,Granada,es La Liga,25,1995,0.3,2,2,1,0,1,2,3,66.7,1,0,0,0,1,3,0,0
Adrien Rabiot,fr FRA,MF,Juventus,it Serie A,26,1995,25.4,64,43,32,24,8,15,34,44.1,19,34,8,26,20,84,41,1
Uroš Račić,rs SRB,MF,Valencia,es La Liga,23,1998,13.4,32,18,9,19,4,12,33,36.4,21,16,6,10,16,48,21,0
Nemanja Radoja,rs SRB,MF,Levante,es La Liga,28,1993,13.5,25,8,9,13,3,8,20,40.0,12,16,9,7,22,47,16,2
Nemanja Radonjić,rs SRB,FW,Marseille,fr Ligue 1,25,1996,0.2,0,0,0,0,0,0,0,,0,0,0,0,0,0,0,0
Ivan Radovanović,rs SRB,DFMF,Salernitana,it Serie A,32,1988,11.7,11,7,8,3,0,7,19,36.8,12,14,7,7,7,18,29,0
Ionuț Radu,ro ROU,GK,Inter,it Serie A,24,1997,1,0,0,0,0,0,0,0,,0,0,0,0,0,0,0,1
Ștefan Radu,ro ROU,DF,Lazio,it Serie A,34,1986,6.2,9,6,3,6,0,5,9,55.6,4,7,2,5,5,14,15,0
Boris Radunović,rs SRB,GK,Cagliari,it Serie A,25,1996,3,0,0,0,0,0,0,0,,0,0,0,0,0,0,0,0
Sidney Raebiger,de GER,MF,RB Leipzig,de Bundesliga,16,2005,0,0,0,0,0,0,0,0,,0,0,0,0,0,0,0,0
Rafinha,br BRA,MF,Real Sociedad,es La Liga,28,1993,11.7,43,27,17,20,6,16,28,57.1,12,21,2,19,12,55,4,0
Rafinha,br BRA,FWMF,Paris S-G,fr Ligue 1,28,1993,2.4,14,8,3,9,2,7,11,63.6,4,3,0,3,4,18,0,0
Antonio Raillo,es ESP,DF,Mallorca,es La Liga,29,1991,17,16,7,10,4,2,5,6,83.3,1,17,14,3,18,34,81,0
Antonio Raimondo,it ITA,FW,Bologna,it Serie A,17,2004,0.8,0,0,0,0,0,0,1,0.0,1,1,0,1,0,0,1,0
Predrag Rajković,rs SRB,GK,Reims,fr Ligue 1,25,1995,38,2,2,2,0,0,2,3,66.7,1,1,0,1,1,3,21,1
Jesuran Rak Sakyi,eng ENG,FWMF,Crystal Palace,eng Premier League,18,2002,0.9,0,0,0,0,0,0,1,0.0,1,3,0,3,1,1,0,0
Ivan Rakitić,hr CRO,MF,Sevilla,es La Liga,33,1988,24.2,40,22,12,23,5,13,40,32.5,27,31,8,23,23,63,35,0
Diant Ramaj,de GER,GK,Eint Frankfurt,de Bundesliga,19,2001,1,0,0,0,0,0,0,0,,0,0,0,0,0,0,3,0
Jonás Ramalho,es ESP,DF,Osasuna,es La Liga,28,1993,2.7,4,2,2,2,0,2,3,66.7,1,4,1,3,3,7,9,0
Adil Rami,fr FRA,DF,Troyes,fr Ligue 1,35,1985,13,10,9,6,4,0,7,8,87.5,1,17,9,8,16,26,43,0
Sandro Ramírez,es ESP,FW,Getafe,es La Liga,26,1995,16.2,7,3,1,3,3,1,12,8.3,11,14,3,11,2,9,3,0
Guilherme Ramos,pt POR,DF,Arminia,de Bundesliga,23,1997,10.1,25,15,17,8,0,12,19,63.2,7,21,8,13,27,52,51,0
Sergio Ramos,es ESP,DF,Paris S-G,fr Ligue 1,35,1986,8.9,12,5,6,6,0,8,15,53.3,7,4,2,2,8,20,27,0
Aaron Ramsdale,eng ENG,GK,Arsenal,eng Premier League,23,1998,34,2,1,2,0,0,1,2,50.0,1,0,0,0,0,2,26,3
Aaron Ramsey,wls WAL,MF,Juventus,it Serie A,30,1990,1.1,0,0,0,0,0,0,0,,0,0,0,0,1,1,0,0
Jacob Ramsey,eng ENG,MF,Aston Villa,eng Premier League,20,2001,27.4,67,44,31,28,8,30,69,43.5,39,36,7,29,24,91,28,0
Luca Ranieri,it ITA,DF,Salernitana,it Serie A,22,1999,23.4,38,21,23,11,4,19,33,57.6,14,18,8,10,22,60,67,0
Andrea Ranocchia,it ITA,DF,Inter,it Serie A,33,1988,3.8,8,4,5,1,2,1,3,33.3,2,4,3,1,4,12,16,0
Raphinha,br BRA,FWMF,Leeds United,eng Premier League,24,1996,32.4,51,29,25,14,12,22,71,31.0,49,43,0,43,29,80,28,1
Tobias Raschl,de GER,MF,Greuther Fürth,de Bundesliga,21,2000,6.6,12,9,4,8,0,5,7,71.4,2,10,1,9,3,15,1,0
Elba Rashani,xk KVX,FWMF,Clermont Foot,fr Ligue 1,28,1993,19.5,40,21,15,21,4,17,55,30.9,38,34,3,31,11,51,20,0
Marcus Rashford,eng ENG,FWMF,Manchester Utd,eng Premier League,23,1997,13.7,6,5,1,4,1,2,13,15.4,11,10,1,9,5,11,5,1
Milot Rashica,xk KVX,FWMF,Norwich City,eng Premier League,25,1996,24.8,31,19,12,12,7,11,30,36.7,19,22,3,19,15,46,23,0
Giacomo Raspadori,it ITA,MFFW,Sassuolo,it Serie A,21,2000,30.4,29,18,5,15,9,11,38,28.9,27,29,3,26,9,38,11,0
Raúl,es ESP,FWDF,Betis,es La Liga,20,2000,0,0,0,0,0,0,0,0,,0,0,0,0,0,0,0,0
David Raum,de GER,DFFW,Hoffenheim,de Bundesliga,23,1998,30.6,52,29,30,10,12,30,64,46.9,34,38,5,33,27,79,39,1
Nicola Ravaglia,it ITA,GK,Sampdoria,it Serie A,32,1988,0.1,0,0,0,0,0,0,0,,0,0,0,0,0,0,0,0
David Raya,es ESP,GK,Brentford,eng Premier League,25,1995,24,0,0,0,0,0,0,0,,0,1,0,1,0,0,10,1
Ante Rebić,hr CRO,FW,Milan,it Serie A,27,1993,9.9,14,8,3,6,5,7,20,35.0,13,14,0,14,3,17,3,1
Arkadiusz Reca,pl POL,DF,Spezia,it Serie A,26,1995,19.7,31,19,21,3,7,20,30,66.7,10,20,7,13,32,63,47,2
Lluís Recasens,es ESP,DF,Espanyol,es La Liga,19,2002,0.5,2,0,2,0,0,1,1,100.0,0,0,0,0,2,4,2,0
Nathan Redmond,eng ENG,MFFW,Southampton,eng Premier League,27,1994,20.4,22,14,9,9,4,7,30,23.3,23,21,2,19,8,30,16,0
Sergio Reguilón,es ESP,DFMF,Tottenham,eng Premier League,24,1996,21.3,40,24,15,18,7,22,43,51.2,21,20,8,12,31,71,45,1
Manolo Reina,es ESP,GK,Mallorca,es La Liga,36,1985,21,0,0,0,0,0,0,0,,0,0,0,0,1,1,6,2
Pepe Reina,es ESP,GK,Lazio,it Serie A,38,1982,15,0,0,0,0,0,0,1,0.0,1,0,0,0,0,0,1,1
Jeff Reine-Adélaïde,fr FRA,MFDF,Lyon,fr Ligue 1,23,1998,2.2,5,3,4,1,0,4,5,80.0,1,2,0,2,0,5,0,1
Reinier,br BRA,FWMF,Dortmund,de Bundesliga,19,2002,1.8,5,3,4,0,1,1,1,100.0,0,3,0,3,0,5,0,0
Karim Rekik,nl NED,DF,Sevilla,es La Liga,26,1994,12.2,11,8,4,6,1,2,9,22.2,7,11,6,5,9,20,19,0
Álex Remiro,es ESP,GK,Real Sociedad,es La Liga,26,1995,35,0,0,0,0,0,0,0,,0,0,0,0,1,1,24,2
Panagiotis Retsos,gr GRE,DF,Hellas Verona,it Serie A,22,1998,0.6,0,0,0,0,0,0,2,0.0,2,0,0,0,2,2,3,0
Panagiotis Retsos,gr GRE,DFFW,Leverkusen,de Bundesliga,22,1998,0.4,0,0,0,0,0,0,0,,0,0,0,0,1,1,0,1
Marco Reus,de GER,MFFW,Dortmund,de Bundesliga,32,1989,27.8,45,30,13,21,11,16,42,38.1,26,23,6,17,12,57,41,1
Elvis Rexhbeçaj,de GER,MF,Bochum,de Bundesliga,23,1997,28.2,43,20,17,21,5,19,42,45.2,23,41,6,35,27,70,15,0
Gio Reyna,us USA,MF,Dortmund,de Bundesliga,18,2002,4.9,7,4,2,4,1,3,9,33.3,6,6,0,6,1,8,3,0
Bryan Reynolds,us USA,DF,Roma,it Serie A,20,2001,0,0,0,0,0,0,0,1,0.0,1,0,0,0,0,0,1,0
Nico Ribaudo,es ESP,MFFW,Espanyol,es La Liga,20,2001,12.4,15,6,9,5,1,11,34,32.4,23,14,2,12,7,22,3,0
Tiago Ribeiro,pt POR,FW,Monaco,fr Ligue 1,19,2002,0,0,0,0,0,0,0,0,,0,0,0,0,0,0,0,0
Franck Ribéry,fr FRA,MFFW,Salernitana,it Serie A,38,1983,15.8,17,10,6,6,5,8,13,61.5,5,12,0,12,3,20,1,0
Samuele Ricci,it ITA,MF,Torino,it Serie A,19,2001,8,8,4,4,2,2,2,5,40.0,3,7,1,6,14,22,9,0
Samuele Ricci,it ITA,MF,Empoli,it Serie A,19,2001,17,33,19,17,13,3,20,34,58.8,14,24,5,19,31,64,18,0
Declan Rice,eng ENG,MF,West Ham,eng Premier League,22,1999,35.3,80,42,45,32,3,38,71,53.5,33,45,21,24,63,143,52,1
Chris Richards,us USA,DF,Hoffenheim,de Bundesliga,21,2000,14.5,26,15,10,15,1,11,18,61.1,7,21,9,12,22,48,50,1
Chris Richards,us USA,DF,Bayern Munich,de Bundesliga,21,2000,0,0,0,0,0,0,0,0,,0,1,0,1,0,0,0,0
Omar Richards,eng ENG,DF,Bayern Munich,de Bundesliga,23,1998,4.9,19,12,11,5,3,11,16,68.8,5,7,1,6,4,23,7,0
Taylor Richards,eng ENG,MF,Brighton,eng Premier League,20,2000,0.3,1,0,0,1,0,1,2,50.0,1,0,0,0,0,1,0,0
Richarlison,br BRA,FW,Everton,eng Premier League,24,1997,28,40,23,18,15,7,15,31,48.4,16,42,4,38,12,52,34,0
Marco Richter,de GER,FWMF,Hertha BSC,de Bundesliga,23,1997,18.9,30,16,14,10,6,13,36,36.1,23,30,4,26,16,46,24,0
Diego Rico,es ESP,DF,Real Sociedad,es La Liga,28,1993,18.3,41,20,19,17,5,22,45,48.9,23,29,4,25,30,71,54,0
Sergio Rico,es ESP,GK,Mallorca,es La Liga,27,1993,14,0,0,0,0,0,0,0,,0,0,0,0,0,0,5,2
Sergio Rico,es ESP,GK,Paris S-G,fr Ligue 1,27,1993,0.3,0,0,0,0,0,0,0,,0,0,0,0,0,0,1,0
Jaïro Riedewald,nl NED,MF,Crystal Palace,eng Premier League,24,1996,1.3,1,1,0,1,0,1,2,50.0,1,1,0,1,1,2,2,0
Manuel Riemann,de GER,GK,Bochum,de Bundesliga,32,1988,31,1,0,1,0,0,1,4,25.0,3,0,0,0,1,2,12,3
Tomás Rincón,ve VEN,MF,Torino,it Serie A,33,1988,1.8,2,2,2,0,0,0,3,0.0,3,3,1,2,2,4,4,0
Tomás Rincón,ve VEN,MF,Sampdoria,it Serie A,33,1988,13,22,13,9,10,3,13,34,38.2,21,15,2,13,18,40,11,0
Luis Rioja,es ESP,MFFW,Alavés,es La Liga,27,1993,34.6,28,15,11,10,7,14,58,24.1,44,22,1,21,25,53,20,0
Renaud Ripart,fr FRA,MFFW,Troyes,fr Ligue 1,28,1993,21,38,21,18,15,5,18,50,36.0,32,21,1,20,19,57,21,1
Mihailo Ristić,rs SRB,DF,Montpellier,fr Ligue 1,25,1995,20,44,32,26,16,2,25,43,58.1,18,16,6,10,17,61,48,0
Matt Ritchie,sct SCO,DF,Newcastle Utd,eng Premier League,31,1989,14.9,22,15,10,10,2,10,27,37.0,17,10,2,8,13,35,26,0
Maxence Rivera,fr FRA,FW,Saint-Étienne,fr Ligue 1,19,2002,0.1,0,0,0,0,0,0,0,,0,0,0,0,0,0,0,0
Rober,es ESP,DF,Levante,es La Liga,26,1995,22.3,36,20,27,7,2,23,39,59.0,16,25,15,10,30,66,90,1
Sergi Roberto,es ESP,MFDF,Barcelona,es La Liga,29,1992,4.4,5,1,2,3,0,3,5,60.0,2,2,0,2,4,9,6,0
Connor Roberts,wls WAL,DF,Burnley,eng Premier League,25,1995,18.8,20,13,10,7,3,10,15,66.7,5,25,5,20,22,42,62,1
Patrick Roberts,eng ENG,MF,Troyes,fr Ligue 1,24,1997,0.2,0,0,0,0,0,0,0,,0,0,0,0,0,0,0,0
Tyler Roberts,wls WAL,MFFW,Leeds United,eng Premier League,22,1999,11,16,7,6,7,3,9,16,56.3,7,11,1,10,5,21,11,0
Andrew Robertson,sct SCO,DF,Liverpool,eng Premier League,27,1994,28.2,36,21,16,15,5,20,35,57.1,15,24,3,21,23,59,61,0
Marc Roca,es ESP,MF,Bayern Munich,de Bundesliga,24,1996,4.2,9,7,2,4,3,2,8,25.0,6,6,0,6,6,15,4,0
Rubén Rochina,es ESP,MFFW,Granada,es La Liga,30,1991,8.3,21,13,7,8,6,8,28,28.6,20,11,1,10,6,27,5,1
Cimo Röcker,de GER,DF,Hertha BSC,de Bundesliga,27,1994,0.2,0,0,0,0,0,0,0,,0,0,0,0,2,2,0,0
Enzo Roco,cl CHI,DF,Elche,es La Liga,28,1992,28.4,36,20,24,11,1,15,24,62.5,9,38,27,11,28,64,110,3
Stian Rode Gregersen,no NOR,DF,Bordeaux,fr Ligue 1,26,1995,21.7,39,26,23,12,4,18,33,54.5,15,26,16,10,38,77,103,2
Sebastian Rode,de GER,MF,Eint Frankfurt,de Bundesliga,30,1990,8.4,15,7,5,8,2,5,17,29.4,12,11,1,10,13,28,8,0
Joe Rodon,wls WAL,DF,Tottenham,eng Premier League,23,1997,1,0,0,0,0,0,0,0,,0,2,1,1,0,0,7,0
Rodri,es ESP,MF,Manchester City,eng Premier League,25,1996,32,72,43,24,38,10,32,59,54.2,27,28,5,23,28,100,45,0
Rodrigo,es ESP,MFFW,Leeds United,eng Premier League,30,1991,25.2,20,9,7,6,7,4,32,12.5,28,12,0,12,11,31,27,1
Rodrigo,es ESP,FW,Betis,es La Liga,21,2000,9.8,10,7,4,5,1,5,22,22.7,17,11,0,11,3,13,4,0
Gerson Rodrigues,lu LUX,FWMF,Troyes,fr Ligue 1,26,1995,9.4,12,9,2,6,4,1,17,5.9,16,8,1,7,0,12,2,0
Kévin Rodrigues,pt POR,DFFW,Rayo Vallecano,es La Liga,27,1994,4.8,15,11,8,7,0,6,10,60.0,4,10,1,9,7,22,6,0
Ángel Rodríguez,es ESP,FWMF,Mallorca,es La Liga,34,1987,17.2,15,9,6,7,2,4,21,19.0,17,15,1,14,3,18,13,0
Óscar Rodríguez Arnaiz,es ESP,MFFW,Getafe,es La Liga,23,1998,10.5,16,11,6,8,2,4,12,33.3,8,7,1,6,11,27,6,0
Óscar Rodríguez Arnaiz,es ESP,FWMF,Sevilla,es La Liga,23,1998,4.6,4,3,1,3,0,2,3,66.7,1,2,0,2,5,9,7,1
Dani Rodríguez,es ESP,MFFW,Mallorca,es La Liga,33,1988,31.5,53,31,20,24,9,15,46,32.6,31,28,3,25,20,73,27,0
Guido Rodríguez,ar ARG,MF,Betis,es La Liga,27,1994,28.1,97,53,46,45,6,54,98,55.1,44,55,12,43,31,128,56,0
Jay Rodriguez,eng ENG,FW,Burnley,eng Premier League,32,1989,15.4,20,12,8,8,4,4,14,28.6,10,19,1,18,4,24,12,0
Ricardo Rodríguez,ch SUI,DF,Torino,it Serie A,28,1992,27.5,36,21,11,23,2,18,33,54.5,15,22,8,14,41,77,48,1
Rodrygo,br BRA,FW,Real Madrid,es La Liga,20,2001,16.9,18,14,7,4,7,3,18,16.7,15,21,0,21,11,29,3,0
Mads Roerslev,dk DEN,DF,Brentford,eng Premier League,22,1999,13.8,23,12,19,2,2,14,32,43.8,18,14,5,9,16,39,29,0
Marko Rog,hr CRO,MF,Cagliari,it Serie A,26,1995,3.5,5,3,1,2,2,1,8,12.5,7,6,1,5,1,6,3,0
Rogério,br BRA,DF,Sassuolo,it Serie A,23,1998,19.2,21,13,12,5,4,15,22,68.2,7,20,8,12,18,39,42,1
Alessio Romagnoli,it ITA,DF,Milan,it Serie A,26,1995,15.7,24,14,14,10,0,14,18,77.8,4,21,12,9,19,43,45,0
Simone Romagnoli,it ITA,DF,Empoli,it Serie A,31,1990,16.6,28,12,14,12,2,15,20,75.0,5,34,28,6,9,37,86,0
Leonardo Román,es ESP,GK,Mallorca,es La Liga,21,2000,2,0,0,0,0,0,0,0,,0,0,0,0,0,0,2,0
Cristian Romero,ar ARG,DF,Tottenham,eng Premier League,23,1998,20.5,62,39,39,21,2,22,34,64.7,12,46,21,25,33,95,74,1
Iván Romero,es ESP,FW,Sevilla,es La Liga,20,2001,2,2,2,0,2,0,0,0,,0,1,0,1,2,4,0,0
Luka Romero,ar ARG,FW,Lazio,it Serie A,16,2004,0.9,2,1,0,1,1,0,2,0.0,2,0,0,0,1,3,0,0
Sergio Romero,ar ARG,GK,Venezia,it Serie A,34,1987,16,2,2,2,0,0,2,2,100.0,0,0,0,0,1,3,10,0
Oriol Romeu,es ESP,MF,Southampton,eng Premier League,29,1991,32.1,77,39,25,45,7,28,73,38.4,45,39,8,31,51,128,43,0
Cristiano Ronaldo,pt POR,FW,Manchester Utd,eng Premier League,36,1985,27.3,8,6,1,5,2,2,6,33.3,4,8,0,8,2,10,29,0
Cristiano Ronaldo,pt POR,FW,Juventus,it Serie A,36,1985,0.3,1,0,0,1,0,1,1,100.0,0,0,0,0,0,1,0,0
Salomón Rondón,ve VEN,FW,Everton,eng Premier League,31,1989,8.8,6,1,1,2,3,4,14,28.6,10,5,0,5,0,6,10,0
Valentin Rongier,fr FRA,MFDF,Marseille,fr Ligue 1,26,1994,24.4,77,51,36,36,5,28,60,46.7,32,26,5,21,33,110,14,0
Marten de Roon,nl NED,MFDF,Atalanta,it Serie A,30,1991,28.3,69,42,33,29,7,34,62,54.8,28,36,2,34,45,114,41,0
Unai Ropero,es ESP,MF,Alavés,es La Liga,19,2001,0.1,0,0,0,0,0,0,0,,0,0,0,0,1,1,0,0
Pablo Rosario,nl NED,MF,Nice,fr Ligue 1,24,1997,30.3,59,37,18,32,9,26,66,39.4,40,33,7,26,38,97,43,0
Romario Rösch,de GER,MF,Mainz 05,de Bundesliga,22,1999,0,0,0,0,0,0,0,0,,0,0,0,0,0,0,0,0
Danny Rose,eng ENG,DF,Watford,eng Premier League,31,1990,7.7,16,10,11,4,1,10,24,41.7,14,8,5,3,14,30,11,1
Francesco Rossi,it ITA,GK,Atalanta,it Serie A,30,1991,0.4,0,0,0,0,0,0,0,,0,0,0,0,0,0,0,0
Tom Rothe,de GER,DF,Dortmund,de Bundesliga,16,2004,1,4,3,2,2,0,3,6,50.0,3,2,0,2,2,6,3,0
Jérôme Roussillon,fr FRA,DF,Wolfsburg,de Bundesliga,28,1993,19.7,14,9,8,6,0,10,16,62.5,6,24,5,19,14,28,34,2
Nicolò Rovella,it ITA,MF,Genoa,it Serie A,19,2001,16.3,37,26,16,14,7,15,40,37.5,25,21,1,20,20,57,20,0
Jon Rowe,eng ENG,FWMF,Norwich City,eng Premier League,18,2003,2.5,3,2,2,1,0,2,3,66.7,1,7,0,7,3,6,1,0
Amir Rrahmani,xk KVX,DF,Napoli,it Serie A,27,1994,32.5,21,11,15,5,1,15,19,78.9,4,36,25,11,19,40,89,0
Ruan,br BRA,DF,Sassuolo,it Serie A,22,1999,2.4,7,4,7,0,0,3,4,75.0,1,6,5,1,2,9,24,1
Rubén,es ESP,DF,Espanyol,es La Liga,20,2001,1.7,6,1,4,2,0,4,7,57.1,3,0,0,0,2,8,4,0
John Ruddy,eng ENG,GK,Wolves,eng Premier League,34,1986,1.5,0,0,0,0,0,0,0,,0,0,0,0,0,0,3,0
Antonio Rüdiger,de GER,DF,Chelsea,eng Premier League,28,1993,33.7,48,28,29,15,4,36,48,75.0,12,20,11,9,28,76,91,1
Sebastian Rudy,de GER,MF,Hoffenheim,de Bundesliga,31,1990,8.6,22,12,9,13,0,11,21,52.4,10,8,3,5,11,33,8,1
Daniele Rugani,it ITA,DF,Juventus,it Serie A,27,1994,9.8,8,5,4,4,0,4,7,57.1,3,9,4,5,11,19,47,0
Matteo Ruggeri,it ITA,DF,Salernitana,it Serie A,19,2002,7.5,8,4,5,2,1,7,10,70.0,3,6,1,5,2,10,25,0
Mário Rui,pt POR,DF,Napoli,it Serie A,30,1991,33.2,68,43,32,28,8,39,84,46.4,45,31,7,24,40,108,50,0
Aitor Ruibal,es ESP,FWDF,Betis,es La Liga,25,1996,9.5,21,15,13,3,5,10,34,29.4,24,8,0,8,8,29,6,0
Isma Ruiz,es ESP,MF,Granada,es La Liga,20,2001,3.1,3,1,3,0,0,1,9,11.1,8,5,2,3,3,6,2,0
Fabián Ruiz Peña,es ESP,MF,Napoli,it Serie A,25,1996,26.5,55,33,22,29,4,29,67,43.3,38,34,1,33,22,77,32,0
Víctor Ruiz,es ESP,DF,Betis,es La Liga,32,1989,15.8,11,9,7,2,2,6,9,66.7,3,18,13,5,29,40,71,1
Gerónimo Rulli,ar ARG,GK,Villarreal,es La Liga,29,1992,32,0,0,0,0,0,0,4,0.0,4,0,0,0,1,1,15,5
Lukas Rupp,de GER,MF,Norwich City,eng Premier League,30,1991,8.5,9,4,5,3,1,4,15,26.7,11,11,1,10,9,18,7,0
Alessandro Russo,it ITA,MF,Salernitana,it Serie A,17,2003,0.3,1,0,1,0,0,0,1,0.0,1,0,0,0,0,1,1,0
Franco Russo,ar ARG,DF,Mallorca,es La Liga,26,1994,16.3,19,10,10,9,0,13,31,41.9,18,14,9,5,27,46,73,1
Georginio Rutter,fr FRA,FWMF,Hoffenheim,de Bundesliga,19,2002,17.9,18,13,4,8,6,6,17,35.3,11,29,1,28,6,24,11,1
Mathew Ryan,au AUS,GK,Real Sociedad,es La Liga,29,1992,3,0,0,0,0,0,0,0,,0,0,0,0,0,0,2,0
Julian Ryerson,no NOR,DF,Union Berlin,de Bundesliga,23,1997,15.9,27,15,11,12,4,17,25,68.0,8,12,4,8,16,43,32,0
Frederik Rønnow,dk DEN,GK,Union Berlin,de Bundesliga,28,1992,7,0,0,0,0,0,0,0,,0,0,0,0,0,0,1,0
José Sá,pt POR,GK,Wolves,eng Premier League,28,1993,36.5,2,1,2,0,0,2,4,50.0,2,0,0,0,2,4,19,5
Roli Pereira de Sa,fr FRA,MF,Nantes,fr Ligue 1,24,1996,6.4,12,4,3,5,4,3,20,15.0,17,6,0,6,6,18,3,0
Youssouf Sabaly,sn SEN,DF,Betis,es La Liga,28,1993,8.8,12,10,11,0,1,7,13,53.8,6,11,4,7,13,25,16,1
Mathys Saban,fr FRA,FWMF,Saint-Étienne,fr Ligue 1,19,2002,0.8,4,2,2,2,0,1,1,100.0,0,1,0,1,0,4,0,0
Stefano Sabelli,it ITA,DF,Genoa,it Serie A,28,1993,3.9,6,3,3,2,1,3,9,33.3,6,5,1,4,3,9,12,0
Abdelhamid Sabiri,ma MAR,MFFW,Sampdoria,it Serie A,24,1996,9.9,34,18,10,15,9,7,25,28.0,18,10,2,8,7,41,3,0
Marcel Sabitzer,at AUT,MFDF,Bayern Munich,de Bundesliga,27,1994,10.1,18,7,8,8,2,9,19,47.4,10,7,0,7,9,27,10,1
Marcel Sabitzer,at AUT,MFFW,RB Leipzig,de Bundesliga,27,1994,0.5,2,1,1,1,0,1,1,100.0,0,0,0,0,1,3,0,0
Falaye Sacko,ml MLI,DF,Saint-Étienne,fr Ligue 1,26,1995,7.4,15,10,14,1,0,13,16,81.3,3,11,7,4,4,19,18,2
Alexis Saelemaekers,be BEL,FW,Milan,it Serie A,22,1999,20.7,43,22,12,17,14,15,51,29.4,36,19,0,19,15,58,8,0
Rafiki Said Ahamada,fr FRA,MFFW,Brest,fr Ligue 1,21,2000,1.4,4,3,1,2,1,3,4,75.0,1,2,0,2,0,4,0,0
Wesley Saïd,fr FRA,FWMF,Lens,fr Ligue 1,26,1995,7.3,10,5,1,8,1,1,9,11.1,8,4,0,4,2,12,0,0
Allan Saint-Maximin,fr FRA,FWMF,Newcastle Utd,eng Premier League,24,1997,31.2,13,8,6,4,3,3,17,17.6,14,13,2,11,11,24,3,0
Romain Saïss,ma MAR,DF,Wolves,eng Premier League,31,1990,30.1,40,27,28,11,1,19,33,57.6,14,41,21,20,58,98,158,2
Bukayo Saka,eng ENG,FWMF,Arsenal,eng Premier League,19,2001,33.1,40,21,12,17,11,13,39,33.3,26,28,2,26,22,62,23,0
Mamadou Sakho,fr FRA,DF,Montpellier,fr Ligue 1,31,1990,28.6,34,22,26,8,0,16,26,61.5,10,41,34,7,41,75,134,4
Bakary Sako,ml MLI,FWMF,Saint-Étienne,fr Ligue 1,33,1988,1.7,0,0,0,0,0,0,1,0.0,1,3,1,2,0,0,0,0
Jacopo Sala,it ITA,MF,Spezia,it Serie A,29,1991,9.8,22,11,10,10,2,13,30,43.3,17,6,0,6,14,36,11,0
Mohamed Salah,eg EGY,FW,Liverpool,eng Premier League,29,1992,30.7,17,8,5,9,3,6,19,31.6,13,7,1,6,6,23,5,0
Eddie Salcedo,it ITA,MFFW,Spezia,it Serie A,19,2001,4.8,1,1,0,0,1,0,1,0.0,1,2,1,1,0,1,7,1
William Saliba,fr FRA,DF,Marseille,fr Ligue 1,20,2001,36,54,32,36,16,2,27,35,77.1,8,24,16,8,48,102,85,0
Romain Salin,fr FRA,GK,Rennes,fr Ligue 1,37,1984,1,0,0,0,0,0,0,0,,0,0,0,0,0,0,0,0
Mohammed Salisu,gh GHA,DF,Southampton,eng Premier League,22,1999,33,80,47,54,22,4,40,65,61.5,25,49,26,23,78,158,158,4
Roland Sallai,hu HUN,MFFW,Freiburg,de Bundesliga,24,1997,17.2,22,16,8,11,3,7,23,30.4,16,12,0,12,11,33,12,0
Yoann Salmier,gf GUF,DF,Troyes,fr Ligue 1,28,1992,29.6,58,33,44,11,3,26,34,76.5,8,30,14,16,40,98,94,0
Salvi,es ESP,MFFW,Cádiz,es La Liga,30,1991,15.5,20,10,9,8,3,8,20,40.0,12,17,2,15,6,26,11,0
Lazar Samardzic,de GER,MFFW,Udinese,it Serie A,19,2002,5.4,13,9,4,7,2,7,26,26.9,19,6,0,6,2,15,2,0
Diadie Samassékou,ml MLI,MF,Hoffenheim,de Bundesliga,25,1996,18.4,41,26,14,21,6,22,45,48.9,23,27,11,16,28,69,26,0
Mama Samba Baldé,gw GNB,MFFW,Troyes,fr Ligue 1,25,1995,19.1,40,28,16,14,10,8,26,30.8,18,32,1,31,5,45,9,0
Albert Sambi Lokonga,be BEL,MF,Arsenal,eng Premier League,21,1999,12.6,22,18,11,9,2,12,14,85.7,2,12,7,5,13,35,12,4
Junior Sambia,fr FRA,DFFW,Montpellier,fr Ligue 1,24,1996,17,22,13,12,7,3,13,22,59.1,9,22,3,19,21,43,31,0
Luigi Samele,it ITA,FW,Sassuolo,it Serie A,19,2002,0.1,0,0,0,0,0,0,0,,0,0,0,0,0,0,1,0
Fede San Emeterio,es ESP,MF,Cádiz,es La Liga,24,1997,9.2,16,5,5,8,3,5,15,33.3,10,5,0,5,8,24,6,0
Antonio Sanabria,py PAR,FW,Torino,it Serie A,25,1996,20,3,2,0,1,2,1,4,25.0,3,11,4,7,2,5,10,0
Oihan Sancet,es ESP,FW,Athletic Club,es La Liga,21,2000,15.8,12,7,2,8,2,5,20,25.0,15,2,0,2,5,17,13,0
Renato Sanches,pt POR,MFFW,Lille,fr Ligue 1,23,1997,18.3,19,7,8,10,1,9,26,34.6,17,14,3,11,14,33,7,0
Alexis Sánchez,cl CHI,FW,Inter,it Serie A,32,1988,9.8,9,8,0,6,3,2,11,18.2,9,4,0,4,2,11,3,0
Antonio Sánchez,es ESP,MFFW,Mallorca,es La Liga,24,1997,18,53,24,29,17,7,19,49,38.8,30,32,2,30,32,85,32,1
Davinson Sánchez,co COL,DF,Tottenham,eng Premier League,25,1996,18.1,41,22,25,14,2,19,28,67.9,9,24,16,8,30,71,54,3
Germán Sánchez,es ESP,DF,Granada,es La Liga,34,1986,25.5,27,19,18,9,0,11,20,55.0,9,19,16,3,28,55,137,0
Juan Sánchez,es ESP,,Sevilla,es La Liga,17,2003,0.1,,0,,,,,,,,,,,0,,,
Manuel Sánchez,es ESP,DF,Osasuna,es La Liga,20,2000,25.1,72,34,41,22,9,43,79,54.4,36,28,3,25,18,90,43,0
Robert Sánchez,es ESP,GK,Brighton,eng Premier League,23,1997,37,2,1,2,0,0,1,1,100.0,0,1,0,1,0,2,11,4
Jadon Sancho,eng ENG,FWMF,Manchester Utd,eng Premier League,21,2000,21.1,14,8,9,4,1,8,22,36.4,14,19,0,19,15,29,5,3
Philippe Sandler,nl NED,DF,Troyes,fr Ligue 1,24,1997,0.8,0,0,0,0,0,0,0,,0,1,1,0,3,3,6,0
Alex Sandro,br BRA,DF,Juventus,it Serie A,30,1991,19.8,27,16,15,9,3,11,25,44.0,14,17,6,11,27,54,40,0
Leroy Sané,de GER,FWMF,Bayern Munich,de Bundesliga,25,1996,22,28,16,5,19,4,9,24,37.5,15,18,0,18,12,40,2,1
Oier Sanjurjo,es ESP,MF,Osasuna,es La Liga,35,1986,8.4,10,6,3,7,0,2,19,10.5,17,8,3,5,1,11,9,0
Mohamed Sankoh,nl NED,FW,Stuttgart,de Bundesliga,17,2003,0,0,0,0,0,0,0,0,,0,0,0,0,0,0,0,0
Morgan Sanson,fr FRA,MF,Aston Villa,eng Premier League,26,1994,4,12,8,7,2,3,3,7,42.9,4,13,0,13,10,22,2,1
Nicola Sansone,it ITA,FWMF,Bologna,it Serie A,29,1991,10,13,7,5,6,2,3,15,20.0,12,1,0,1,4,17,2,0
Baptiste Santamaria,fr FRA,MFDF,Rennes,fr Ligue 1,26,1995,28,52,27,15,31,6,24,44,54.5,20,33,12,21,32,84,42,0
Baptiste Santamaria,fr FRA,MF,Freiburg,de Bundesliga,26,1995,0.2,0,0,0,0,0,0,1,0.0,1,0,0,0,1,1,1,0
Federico Santander,py PAR,FWDF,Bologna,it Serie A,30,1991,0.7,2,1,1,1,0,1,1,100.0,0,0,0,0,0,2,0,0
Jesús Santiago,es ESP,MF,Valencia,es La Liga,17,2004,0.9,2,2,1,1,0,0,2,0.0,2,1,0,1,0,2,1,0
Samir Santos,br BRA,DF,Watford,eng Premier League,26,1994,18.6,24,11,18,6,0,8,19,42.1,11,21,11,10,43,67,85,3
Samir Santos,br BRA,DF,Udinese,it Serie A,26,1994,15.8,36,16,22,13,1,15,25,60.0,10,21,7,14,42,78,62,0
Sergio Santos,es ESP,DF,Real Madrid,es La Liga,20,2001,0.1,0,0,0,0,0,0,0,,0,0,0,0,0,0,0,0
Alvaro Sanz,es ESP,MF,Barcelona,es La Liga,20,2001,0.3,0,0,0,0,0,0,1,0.0,1,0,0,0,0,0,0,0
Riccardo Saponara,it ITA,FW,Fiorentina,it Serie A,29,1991,14.3,10,2,1,6,3,6,16,37.5,10,5,0,5,1,11,3,0
Pablo Sarabia,es ESP,FW,Paris S-G,fr Ligue 1,29,1992,0.2,0,0,0,0,0,0,1,0.0,1,0,0,0,0,0,0,0
Marcelo Saracchi,uy URU,DF,Levante,es La Liga,23,1998,2.1,8,5,6,1,1,2,4,50.0,2,3,0,3,4,12,7,1
Josh Sargent,us USA,FWMF,Norwich City,eng Premier League,21,2000,17.5,26,14,15,7,4,14,39,35.9,25,29,2,27,11,37,18,2
Jeremy Sarmiento,ec ECU,FWMF,Brighton,eng Premier League,19,2002,0.5,1,1,0,0,1,0,2,0.0,2,2,0,2,0,1,0,0
Bouna Sarr,sn SEN,DF,Bayern Munich,de Bundesliga,29,1992,0.7,4,4,2,1,1,4,5,80.0,1,2,1,1,6,10,1,0
Ismaila Sarr,sn SEN,FWMF,Watford,eng Premier League,23,1998,20.7,12,7,4,3,5,5,19,26.3,14,10,1,9,9,21,10,0
Malang Sarr,fr FRA,DF,Chelsea,eng Premier League,22,1999,6.1,14,7,10,2,2,7,12,58.3,5,6,3,3,11,25,20,0
Joan Sastre Vanrell,es ESP,DF,Mallorca,es La Liga,24,1997,2.9,6,3,5,0,1,3,4,75.0,1,3,0,3,2,8,10,0
Giacomo Satalino,it ITA,GK,Sassuolo,it Serie A,22,1999,0.1,0,0,0,0,0,0,0,,0,0,0,0,0,0,0,0
Martin Satriano,uy URU,FWMF,Inter,it Serie A,20,2001,0.4,1,0,0,0,1,1,1,100.0,0,0,0,0,0,1,0,0
Martin Satriano,uy URU,FW,Brest,fr Ligue 1,20,2001,10.4,5,2,1,1,3,2,7,28.6,5,8,0,8,2,7,3,0
Téji Savanier,fr FRA,MF,Montpellier,fr Ligue 1,29,1991,26.8,46,27,18,19,9,21,59,35.6,38,23,1,22,25,71,12,1
Esteban Saveljich,me MNE,DF,Rayo Vallecano,es La Liga,30,1991,18.9,18,11,11,7,0,9,15,60.0,6,20,12,8,16,34,69,0
Stefan Savić,me MNE,DF,Atlético Madrid,es La Liga,30,1991,27.1,46,20,25,20,1,29,43,67.4,14,19,12,7,37,83,102,1
Joe Scally,us USA,DF,M'Gladbach,de Bundesliga,18,2002,21.2,40,30,21,14,5,17,41,41.5,24,27,4,23,22,62,38,0
Giorgio Scalvini,it ITA,DFMF,Atalanta,it Serie A,17,2003,8.5,22,11,13,8,1,9,19,47.4,10,12,1,11,22,44,16,0
Gianluca Scamacca,it ITA,FW,Sassuolo,it Serie A,22,1999,23.8,19,14,2,5,12,5,21,23.8,16,16,1,15,5,24,22,1
Dane Scarlett,eng ENG,MF,Tottenham,eng Premier League,17,2004,0,0,0,0,0,0,0,0,,0,0,0,0,0,0,0,0
Kevin Schade,de GER,MFFW,Freiburg,de Bundesliga,19,2001,9.2,9,7,6,2,1,3,10,30.0,7,15,3,12,3,12,16,0
András Schäfer,hu HUN,MF,Union Berlin,de Bundesliga,22,1999,2.7,4,1,3,1,0,0,5,0.0,5,7,1,6,2,6,4,0
Fabian Schär,ch SUI,DF,Newcastle Utd,eng Premier League,29,1991,24,16,11,11,3,2,8,16,50.0,8,27,18,9,32,48,95,2
Louis Schaub,at AUT,MFFW,Köln,de Bundesliga,26,1994,7.3,16,10,7,7,2,11,20,55.0,9,17,3,14,3,19,3,0
Andrea Schiavone,it ITA,MF,Salernitana,it Serie A,28,1993,6.3,14,8,5,9,0,10,23,43.5,13,13,3,10,8,22,12,0
Patrik Schick,cz CZE,FW,Leverkusen,de Bundesliga,25,1996,23.1,5,2,2,2,1,1,9,11.1,8,6,1,5,3,8,28,0
Kingsley Schindler,de GER,DFFW,Köln,de Bundesliga,28,1993,3.9,1,0,0,0,1,1,5,20.0,4,5,1,4,5,6,5,0
Xaver Schlager,at AUT,MF,Wolfsburg,de Bundesliga,23,1997,11.6,43,20,20,20,3,20,49,40.8,29,25,2,23,9,52,14,0
Keven Schlotterbeck,de GER,DFFW,Freiburg,de Bundesliga,24,1997,3.5,11,5,6,5,0,5,6,83.3,1,7,4,3,11,22,24,1
Nico Schlotterbeck,de GER,DF,Freiburg,de Bundesliga,21,1999,30.9,72,43,36,34,2,33,48,68.8,15,41,32,9,56,128,154,1
Jeffrey Schlupp,gh GHA,MFFW,Crystal Palace,eng Premier League,28,1992,20.6,46,25,16,23,7,24,50,48.0,26,39,9,30,18,64,32,0
Kasper Schmeichel,dk DEN,GK,Leicester City,eng Premier League,34,1986,37,0,0,0,0,0,0,2,0.0,2,0,0,0,1,1,15,2
Jonathan Schmid,fr FRA,DF,Freiburg,de Bundesliga,31,1990,6.5,12,6,6,3,3,5,7,71.4,2,7,1,6,6,18,15,0
Benno Schmitz,de GER,DF,Köln,de Bundesliga,26,1994,26.9,57,37,21,27,9,42,86,48.8,44,44,8,36,39,96,39,0
David Schnegg,at AUT,DF,Venezia,it Serie A,22,1998,1.6,2,0,1,1,0,1,3,33.3,2,4,0,4,3,5,6,0
Morgan Schneiderlin,fr FRA,MF,Nice,fr Ligue 1,31,1989,7.2,21,12,9,11,1,6,13,46.2,7,8,2,6,20,41,18,0
Alessandro Schöpf,at AUT,MF,Arminia,de Bundesliga,27,1994,26.6,40,22,19,16,5,14,30,46.7,16,31,5,26,30,70,21,1
Jerdy Schouten,nl NED,MF,Bologna,it Serie A,24,1997,15.5,25,17,10,12,3,9,22,40.9,13,22,5,17,33,58,29,1
Nico Schulz,de GER,DF,Dortmund,de Bundesliga,28,1993,9.3,21,12,9,7,5,9,21,42.9,12,8,1,7,11,32,8,0
Marvin Schwäbe,de GER,GK,Köln,de Bundesliga,26,1995,21,0,0,0,0,0,0,0,,0,0,0,0,0,0,8,1
Alexander Schwolow,de GER,GK,Hertha BSC,de Bundesliga,29,1992,24.2,0,0,0,0,0,0,1,0.0,1,0,0,0,2,2,18,3
Valentino Scotta,es ESP,DF,Sevilla,es La Liga,19,2001,0,0,0,0,0,0,0,0,,0,0,0,0,0,0,0,0
Demba Seck,sn SEN,MFFW,Torino,it Serie A,20,2001,1.6,2,1,0,2,0,0,0,,0,0,0,0,0,2,0,0
Aleksandar Sedlar,rs SRB,DFMF,Mallorca,es La Liga,29,1991,4.5,5,3,4,1,0,3,5,60.0,2,4,4,0,5,10,19,0
Paul Seguin,de GER,MF,Greuther Fürth,de Bundesliga,26,1995,23.4,50,31,15,32,3,26,56,46.4,30,27,3,24,19,69,30,1
Alidu Seidu,gh GHA,DF,Clermont Foot,fr Ligue 1,21,2000,15.7,34,20,20,13,1,16,27,59.3,11,25,11,14,34,68,49,1
Davie Selke,de GER,FW,Hertha BSC,de Bundesliga,26,1995,11.2,5,4,1,3,1,1,3,33.3,2,6,1,5,1,6,11,0
Matz Sels,be BEL,GK,Strasbourg,fr Ligue 1,29,1992,37,1,1,1,0,0,0,0,,0,0,0,0,1,2,22,0
Ken Sema,se SWE,MFFW,Watford,eng Premier League,27,1993,9.5,16,6,11,4,1,9,20,45.0,11,10,0,10,5,21,11,0
Nélson Semedo,pt POR,MFDF,Wolves,eng Premier League,27,1993,23.7,58,39,39,17,2,25,49,51.0,24,23,4,19,21,79,64,1
Lion Semić,de GER,DF,Dortmund,de Bundesliga,17,2003,0,0,0,0,0,0,0,0,,0,0,0,0,0,0,0,0
Adrian Šemper,hr CRO,GK,Genoa,it Serie A,23,1998,1,0,0,0,0,0,0,0,,0,0,0,0,0,0,0,0
Stefano Sensi,it ITA,MFFW,Sampdoria,it Serie A,25,1995,8.4,18,9,10,6,2,10,23,43.5,13,2,0,2,6,24,4,0
Stefano Sensi,it ITA,MFFW,Inter,it Serie A,25,1995,1.9,4,3,1,3,0,2,4,50.0,2,2,0,2,0,4,2,0
Luigi Sepe,it ITA,GK,Salernitana,it Serie A,30,1991,15.5,0,0,0,0,0,0,0,,0,0,0,0,1,1,3,0
Suat Serdar,de GER,MFFW,Hertha BSC,de Bundesliga,24,1997,24.6,64,30,24,29,11,25,55,45.5,30,32,3,29,20,84,14,0
Laurens Serpe,it ITA,DF,Genoa,it Serie A,20,2001,0.5,1,0,1,0,0,1,2,50.0,1,0,0,0,0,1,1,0
Janni Serra,de GER,FW,Arminia,de Bundesliga,23,1998,12.4,4,2,2,0,2,2,7,28.6,5,8,3,5,5,9,19,0
Javier Serrano,es ESP,MF,Atlético Madrid,es La Liga,18,2003,0.8,3,1,0,3,0,2,4,50.0,2,0,0,0,3,6,2,0
Nicolás Serrano,es ESP,MFFW,Athletic Club,es La Liga,18,2003,3.5,9,6,3,5,1,3,10,30.0,7,5,1,4,2,11,3,0
Zidan Sertdemir,dk DEN,MFFW,Leverkusen,de Bundesliga,16,2005,0.2,2,2,2,0,0,0,0,,0,0,0,0,0,2,0,0
Ryan Sessegnon,eng ENG,DFMF,Tottenham,eng Premier League,21,2000,11.6,25,19,14,7,4,11,22,50.0,11,18,3,15,7,32,26,0
Nils Seufert,de GER,MF,Greuther Fürth,de Bundesliga,24,1997,1.1,3,2,1,1,1,0,1,0.0,1,0,0,0,0,3,0,0
Salva Sevilla,es ESP,MF,Mallorca,es La Liga,37,1984,16.7,18,12,8,8,2,6,17,35.3,11,12,6,6,14,32,11,0
Stephan El Shaarawy,it ITA,FWDF,Roma,it Serie A,28,1992,11.7,13,8,4,9,0,4,6,66.7,2,10,2,8,11,24,8,0
Jamie Shackleton,eng ENG,DFMF,Leeds United,eng Premier League,21,1999,7.9,27,16,19,7,1,13,25,52.0,12,11,7,4,8,35,12,1
Xherdan Shaqiri,ch SUI,FWMF,Lyon,fr Ligue 1,29,1991,7.5,7,3,0,5,2,2,10,20.0,8,2,0,2,2,9,2,0
Luke Shaw,eng ENG,DF,Manchester Utd,eng Premier League,26,1995,17.8,21,13,9,9,3,12,21,57.1,9,22,11,11,9,30,22,2
Jonjo Shelvey,eng ENG,MF,Newcastle Utd,eng Premier League,29,1992,22,30,17,12,18,0,14,34,41.2,20,22,7,15,22,52,20,2
Aimar Sher,se SWE,MF,Spezia,it Serie A,18,2002,0.5,2,1,1,1,0,0,1,0.0,1,1,0,1,3,5,1,0
Eldor Shomurodov,uz UZB,FWMF,Roma,it Serie A,26,1995,8.7,5,4,0,4,1,1,10,10.0,9,8,0,8,2,7,5,0
Shola Shoretire,eng ENG,MF,Manchester Utd,eng Premier League,17,2004,0.2,0,0,0,0,0,0,0,,0,0,0,0,0,0,0,0
Mahame Siby,ml MLI,DF,Strasbourg,fr Ligue 1,25,1996,0.2,0,0,0,0,0,0,0,,0,0,0,0,1,1,2,0
Aboubakar Sidibé,fr FRA,DF,Clermont Foot,fr Ligue 1,25,1996,0.1,0,0,0,0,0,0,0,,0,0,0,0,0,0,0,0
Alassane Sidibe,ci CIV,MF,Atalanta,it Serie A,19,2002,0.1,1,1,1,0,0,0,0,,0,0,0,0,0,1,0,0
Djibril Sidibé,fr FRA,DF,Monaco,fr Ligue 1,29,1992,10.5,24,13,13,8,3,9,24,37.5,15,10,1,9,16,40,13,0
Kaj Sierhuis,nl NED,FW,Reims,fr Ligue 1,23,1998,0.9,1,1,1,0,0,1,3,33.3,2,0,0,0,0,1,1,0
Francisco Sierralta,cl CHI,DF,Watford,eng Premier League,24,1997,4.7,7,3,7,0,0,5,8,62.5,3,7,2,5,6,13,35,0
Arnór Sigurðsson,is ISL,FWMF,Venezia,it Serie A,22,1999,2,1,1,0,1,0,1,2,50.0,1,2,0,2,1,2,0,0
Kiliann Sildillia,fr FRA,DFMF,Freiburg,de Bundesliga,19,2002,1.9,7,3,3,4,0,3,6,50.0,3,1,0,1,2,9,7,1
Adrien Silva,pt POR,MF,Sampdoria,it Serie A,32,1989,12,24,12,14,5,5,9,33,27.3,24,15,5,10,23,47,23,0
André Silva,pt POR,FW,RB Leipzig,de Bundesliga,25,1995,23.1,13,9,2,3,8,4,13,30.8,9,20,2,18,2,15,15,0
Bernardo Silva,pt POR,MFFW,Manchester City,eng Premier League,26,1994,31.7,57,29,19,19,19,31,67,46.3,36,24,2,22,20,77,19,0
Caio Henrique Oliveira Silva,br BRA,DF,Monaco,fr Ligue 1,24,1997,29.6,53,30,31,18,4,28,59,47.5,31,30,6,24,27,80,37,3
David Silva,es ESP,MF,Real Sociedad,es La Liga,35,1986,19.1,28,17,10,11,7,3,20,15.0,17,13,3,10,7,35,12,0
Fábio Silva,pt POR,FW,Wolves,eng Premier League,19,2002,6.4,3,2,0,2,1,0,8,0.0,8,2,0,2,1,4,1,0
Gabriel Silva,br BRA,DFMF,Saint-Étienne,fr Ligue 1,30,1991,7.9,12,7,7,2,3,9,13,69.2,4,9,3,6,17,29,13,0
Jonathan Silva,ar ARG,DFFW,Getafe,es La Liga,27,1994,2.5,10,8,4,4,2,7,12,58.3,5,4,0,4,3,13,7,0
Rui Silva,pt POR,GK,Betis,es La Liga,27,1994,21.8,1,0,1,0,0,1,2,50.0,1,0,0,0,1,2,11,1
Thiago Silva,br BRA,DF,Chelsea,eng Premier League,36,1984,29.4,32,21,19,12,1,11,22,50.0,11,54,31,23,44,76,100,0
Marco Silvestri,it ITA,GK,Udinese,it Serie A,30,1991,35,0,0,0,0,0,0,1,0.0,1,0,0,0,1,1,11,1
Mohamed Simakan,fr FRA,DF,RB Leipzig,de Bundesliga,21,2000,22.3,48,27,25,21,2,27,41,65.9,14,22,11,11,40,88,46,1
Giovanni Simeone,ar ARG,FW,Hellas Verona,it Serie A,26,1995,29.5,27,15,6,12,9,9,39,23.1,30,37,3,34,6,33,23,0
Giovanni Simeone,ar ARG,FW,Cagliari,it Serie A,26,1995,0.1,0,0,0,0,0,0,0,,0,0,0,0,0,0,0,0
Giuliano Simeone,ar ARG,MF,Atlético Madrid,es La Liga,18,2002,0,0,0,0,0,0,0,0,,0,0,0,0,0,0,0,0
Ellis Simms,eng ENG,FW,Everton,eng Premier League,20,2001,0.7,0,0,0,0,0,0,0,,0,1,1,0,0,0,1,0
Moses Simon,ng NGA,FWMF,Nantes,fr Ligue 1,26,1995,25.9,17,11,6,5,6,11,23,47.8,12,14,3,11,12,29,5,0
Unai Simón,es ESP,GK,Athletic Club,es La Liga,24,1997,34,0,0,0,0,0,0,0,,0,0,0,0,1,1,5,1
Xavi Simons,nl NED,MFFW,Paris S-G,fr Ligue 1,18,2003,1.5,1,1,0,1,0,1,2,50.0,1,3,0,3,0,1,0,0
Wilfried Singo,ci CIV,DF,Torino,it Serie A,20,2000,29,55,35,24,24,7,24,34,70.6,10,26,6,20,23,78,47,0
Daley Sinkgraven,nl NED,DF,Leverkusen,de Bundesliga,26,1995,3.9,6,2,4,0,2,3,7,42.9,4,3,1,2,3,9,6,0
Tobias Sippel,de GER,GK,M'Gladbach,de Bundesliga,33,1988,1,0,0,0,0,0,0,0,,0,0,0,0,0,0,0,0
Hugo Siquet,be BEL,DF,Freiburg,de Bundesliga,19,2002,0.2,0,0,0,0,0,0,0,,0,0,0,0,0,0,0,0
Salvatore Sirigu,it ITA,GK,Genoa,it Serie A,34,1987,37,1,1,1,0,0,1,2,50.0,1,0,0,0,0,1,19,2
Issouf Sissokho,ml MLI,MF,Bordeaux,fr Ligue 1,19,2002,4.8,17,8,2,13,2,8,17,47.1,9,8,1,7,7,24,0,0
Ibrahima Sissoko,fr FRA,MFDF,Strasbourg,fr Ligue 1,23,1997,25.6,47,23,18,20,9,19,46,41.3,27,32,11,21,35,82,31,0
Moussa Sissoko,fr FRA,MF,Watford,eng Premier League,31,1989,35.8,53,27,27,20,6,28,42,66.7,14,42,13,29,30,83,64,0
Nelson Sissoko,fr FRA,DF,Saint-Étienne,fr Ligue 1,24,1997,0.5,2,0,2,0,0,1,1,100.0,0,0,0,0,0,2,2,0
Sambou Sissoko,fr FRA,MFDF,Reims,fr Ligue 1,22,1999,2,12,6,6,4,2,6,8,75.0,2,2,0,2,2,14,7,0
Antonio Sivera,es ESP,GK,Alavés,es La Liga,24,1996,3.1,0,0,0,0,0,0,1,0.0,1,0,0,0,0,0,0,0
Ellyes Skhiri,tn TUN,MF,Köln,de Bundesliga,26,1995,20.2,55,33,25,26,4,22,41,53.7,19,41,7,34,37,92,35,1
Oliver Skipp,eng ENG,MF,Tottenham,eng Premier League,20,2000,15,33,19,14,18,1,15,31,48.4,16,19,7,12,12,45,10,1
Leo Skiri Østigård,no NOR,DF,Genoa,it Serie A,21,1999,13,16,9,8,7,1,9,11,81.8,2,17,10,7,8,24,55,1
Łukasz Skorupski,pl POL,GK,Bologna,it Serie A,30,1991,36,0,0,0,0,0,0,1,0.0,1,0,0,0,0,0,17,0
Andreas Skov Olsen,dk DEN,FWDF,Bologna,it Serie A,21,1999,8.3,12,10,4,4,4,5,11,45.5,6,9,1,8,3,15,11,0
Robert Skov,dk DEN,FWDF,Hoffenheim,de Bundesliga,25,1996,4.1,3,2,1,1,1,2,9,22.2,7,2,0,2,3,6,3,0
Milan Škriniar,sk SVK,DF,Inter,it Serie A,26,1995,35,47,27,26,17,4,24,42,57.1,18,36,25,11,25,72,90,1
Islam Slimani,dz ALG,FW,Lyon,fr Ligue 1,33,1988,6.4,3,2,0,1,2,1,6,16.7,5,4,0,4,2,5,5,0
William Smallbone,ie IRL,MFFW,Southampton,eng Premier League,21,2000,1.5,4,4,2,2,0,1,3,33.3,2,4,0,4,2,6,0,0
Chris Smalling,eng ENG,DF,Roma,it Serie A,31,1989,23.2,36,23,28,8,0,18,25,72.0,7,32,24,8,26,62,92,1
Emile Smith Rowe,eng ENG,MFFW,Arsenal,eng Premier League,21,2000,21.3,14,7,7,7,0,4,20,20.0,16,18,1,17,15,29,10,1
Cédric Soares,pt POR,DF,Arsenal,eng Premier League,29,1991,16.5,38,26,23,9,6,16,25,64.0,9,18,7,11,16,54,31,1
Danilo Soares,br BRA,DF,Bochum,de Bundesliga,29,1991,28.5,109,71,61,39,9,56,84,66.7,28,63,9,54,62,171,65,2
Rubén Sobrino,es ESP,MF,Valencia,es La Liga,29,1992,0.2,1,1,1,0,0,1,1,100.0,0,1,0,1,2,3,0,0
Rubén Sobrino,es ESP,FWMF,Cádiz,es La Liga,29,1992,20.7,28,17,11,10,7,5,35,14.3,30,21,1,20,21,49,18,0
Alex Sola,es ESP,DFFW,Real Sociedad,es La Liga,22,1999,0.5,1,1,1,0,0,1,3,33.3,2,1,0,1,2,3,3,0
Augusto Solari,ar ARG,MFDF,Celta Vigo,es La Liga,29,1992,7.9,24,12,9,12,3,12,32,37.5,20,14,4,10,7,31,10,1
Roberto Soldado,es ESP,FW,Levante,es La Liga,36,1985,7.4,3,1,0,1,2,1,3,33.3,2,4,0,4,1,4,7,0
Carlos Soler,es ESP,MF,Valencia,es La Liga,24,1997,27.5,29,19,10,15,4,11,37,29.7,26,19,4,15,14,43,28,0
Yann Sommer,ch SUI,GK,M'Gladbach,de Bundesliga,32,1988,33,0,0,0,0,0,0,2,0.0,2,0,0,0,3,3,8,3
Son,es ESP,DF,Levante,es La Liga,27,1994,21.9,28,18,16,7,5,17,34,50.0,17,11,5,6,19,47,33,1
Brandon Soppy,fr FRA,DFMF,Udinese,it Serie A,19,2002,8.6,20,9,8,10,2,11,16,68.8,5,10,2,8,5,25,9,1
David Soria,es ESP,GK,Getafe,es La Liga,28,1993,37.9,1,0,1,0,0,1,2,50.0,1,0,0,0,0,1,22,2
Roberto Soriano,it ITA,MF,Bologna,it Serie A,30,1991,29.1,57,30,27,22,8,17,56,30.4,39,37,3,34,22,79,32,0
Alberto Soro,es ESP,MFFW,Granada,es La Liga,22,1999,6.4,12,10,3,6,3,1,7,14.3,6,21,2,19,3,15,4,0
Borna Sosa,hr CRO,DFFW,Stuttgart,de Bundesliga,23,1998,27.8,22,12,14,5,3,12,26,46.2,14,30,3,27,26,48,61,0
Hugo Sotelo,es ESP,FW,Celta Vigo,es La Liga,17,2003,0,0,0,0,0,0,0,0,,0,0,0,0,0,0,0,0
Florian Sotoca,fr FRA,FWMF,Lens,fr Ligue 1,30,1990,27.6,31,19,7,20,4,12,51,23.5,39,31,4,27,25,56,41,0
Riccardo Sottil,it ITA,FW,Fiorentina,it Serie A,22,1999,13.8,9,4,4,4,1,3,9,33.3,6,3,0,3,1,10,2,0
Tomáš Souček,cz CZE,MF,West Ham,eng Premier League,26,1995,34,66,32,27,33,6,28,65,43.1,37,34,13,21,52,118,98,1
Matìas Soulé,ar ARG,FW,Juventus,it Serie A,18,2003,0.1,0,0,0,0,0,0,1,0.0,1,0,0,0,0,0,0,0
Sambou Soumano,sn SEN,FWMF,Lorient,fr Ligue 1,20,2001,5,4,1,1,2,1,2,2,100.0,0,3,0,3,1,5,7,0
Adama Soumaoro,fr FRA,DF,Bologna,it Serie A,29,1992,25.2,15,5,5,8,2,4,9,44.4,5,22,16,6,34,49,95,0
Boubakary Soumaré,fr FRA,MF,Leicester City,eng Premier League,22,1999,12.2,19,13,10,8,1,8,17,47.1,9,13,1,12,14,33,18,0
Arnaud Souquet,fr FRA,DF,Montpellier,fr Ligue 1,29,1992,25.9,56,35,30,17,9,32,65,49.2,33,21,7,14,34,90,60,1
Djibril Sow,ch SUI,MF,Eint Frankfurt,de Bundesliga,24,1997,26.8,57,33,28,25,4,22,60,36.7,38,35,8,27,50,107,20,1
Saidou Sow,gn GUI,DF,Saint-Étienne,fr Ligue 1,19,2002,11,28,17,21,6,1,16,21,76.2,5,15,5,10,23,51,34,0
Çağlar Söyüncü,tr TUR,DF,Leicester City,eng Premier League,25,1996,27.7,47,30,32,12,3,26,42,61.9,16,44,27,17,32,79,115,1
Leonardo Spinazzola,it ITA,DF,Roma,it Serie A,28,1993,1.4,0,0,0,0,0,0,1,0.0,1,4,1,3,0,0,3,0
Marco Sportiello,it ITA,GK,Atalanta,it Serie A,29,1992,5,0,0,0,0,0,0,0,,0,0,0,0,0,0,2,0
Tony Springett,eng ENG,MFFW,Norwich City,eng Premier League,18,2002,1.6,2,1,1,1,0,1,4,25.0,3,0,0,0,0,2,2,0
Jerry St. Juste,nl NED,DF,Mainz 05,de Bundesliga,24,1996,6.7,13,9,7,6,0,7,8,87.5,1,7,3,4,14,27,14,0
Anton Stach,de GER,MF,Mainz 05,de Bundesliga,22,1998,20.7,28,19,14,13,1,15,38,39.5,23,24,5,19,51,79,25,0
Kostas Stafylidis,gr GRE,DFMF,Bochum,de Bundesliga,27,1993,15.4,39,27,22,14,3,21,27,77.8,6,19,6,13,31,70,44,0
Luca Stanga,it ITA,DF,Milan,it Serie A,19,2002,0,1,0,0,1,0,0,0,,0,0,0,0,0,1,0,0
Josip Stanišić,hr CRO,DF,Bayern Munich,de Bundesliga,21,2000,7.2,21,10,7,12,2,12,18,66.7,6,7,0,7,11,32,10,2
Niklas Stark,de GER,DF,Hertha BSC,de Bundesliga,26,1995,22.6,28,16,18,10,0,12,17,70.6,5,27,17,10,36,64,122,2
Jason Steele,eng ENG,GK,Brighton,eng Premier League,30,1990,1,0,0,0,0,0,0,0,,0,0,0,0,0,0,0,0
Jed Steer,eng ENG,GK,Aston Villa,eng Premier League,28,1992,1,0,0,0,0,0,0,0,,0,0,0,0,0,0,0,0
Renato Steffen,ch SUI,FWMF,Wolfsburg,de Bundesliga,29,1991,10.7,20,16,10,10,0,9,16,56.3,7,7,0,7,13,33,14,0
Zack Steffen,us USA,GK,Manchester City,eng Premier League,26,1995,1,0,0,0,0,0,0,0,,0,0,0,0,0,0,2,0
Calvin Stengs,nl NED,MF,Nice,fr Ligue 1,22,1998,11.9,16,7,6,9,1,7,20,35.0,13,10,0,10,8,24,6,0
Pascal Stenzel,de GER,DF,Stuttgart,de Bundesliga,25,1996,10,24,11,15,5,4,17,33,51.5,16,13,3,10,11,35,25,0
Dale Stephens,eng ENG,MF,Burnley,eng Premier League,32,1989,1.4,4,1,0,3,1,3,8,37.5,5,4,1,3,1,5,1,0
Jack Stephens,eng ENG,DF,Southampton,eng Premier League,27,1994,9,19,12,13,5,1,6,16,37.5,10,12,7,5,19,38,42,0
Raheem Sterling,eng ENG,FW,Manchester City,eng Premier League,26,1994,23.6,23,10,3,11,9,10,23,43.5,13,12,0,12,12,35,3,0
Finley Stevens,wls WAL,DF,Brentford,eng Premier League,18,2003,0.2,3,1,0,3,0,1,1,100.0,0,0,0,0,0,3,0,0
Angelo Stiller,de GER,MF,Hoffenheim,de Bundesliga,20,2001,18.8,30,17,11,15,4,9,23,39.1,14,32,6,26,9,39,16,2
Lars Stindl,de GER,MFFW,M'Gladbach,de Bundesliga,32,1988,18.1,23,15,6,14,3,9,33,27.3,24,28,2,26,10,33,14,0
Riccardo Stivanello,it ITA,DF,Bologna,it Serie A,17,2004,0.5,1,1,1,0,0,1,1,100.0,0,2,2,0,0,1,6,0
Kevin Stöger,at AUT,MF,Mainz 05,de Bundesliga,27,1993,4.7,10,5,5,5,0,4,10,40.0,6,6,0,6,5,15,1,1
Petar Stojanović,si SVN,DF,Empoli,it Serie A,25,1995,30.4,96,63,55,32,9,59,114,51.8,55,39,13,26,27,123,65,1
John Stones,eng ENG,DF,Manchester City,eng Premier League,27,1994,12.4,5,3,3,2,0,2,3,66.7,1,3,3,0,11,16,27,1
Thomas Strakosha,al ALB,GK,Lazio,it Serie A,26,1995,23,0,0,0,0,0,0,0,,0,0,0,0,0,0,7,2
Stefan Strandberg,no NOR,DF,Salernitana,it Serie A,31,1990,10.4,13,8,10,3,0,8,11,72.7,3,15,13,2,9,22,49,0
Dávid Strelec,sk SVK,FWMF,Spezia,it Serie A,20,2001,5.6,4,4,1,2,1,2,9,22.2,7,8,1,7,2,6,1,0
Tobias Strobl,de GER,MFDF,Augsburg,de Bundesliga,31,1990,3.6,8,3,3,5,0,3,11,27.3,8,7,2,5,7,15,3,0
Kevin Strootman,nl NED,MF,Cagliari,it Serie A,31,1990,7.1,8,4,2,4,2,5,12,41.7,7,11,2,9,10,18,15,0
Pascal Struijk,nl NED,DFMF,Leeds United,eng Premier League,21,1999,22.8,61,39,34,23,4,30,50,60.0,20,35,23,12,33,94,60,2
Jens Stryger Larsen,dk DEN,DF,Udinese,it Serie A,30,1991,7.6,5,2,3,1,1,2,3,66.7,1,2,0,2,4,9,17,0
Leo Štulac,si SVN,MF,Empoli,it Serie A,26,1994,9.3,13,6,5,6,2,7,19,36.8,12,6,2,4,8,21,15,0
Stefano Sturaro,it ITA,MF,Genoa,it Serie A,28,1993,19.6,43,26,16,16,11,22,48,45.8,26,25,1,24,15,58,29,2
Damián Suárez,uy URU,DF,Getafe,es La Liga,33,1988,30.1,74,47,34,30,10,42,91,46.2,49,46,5,41,31,105,30,0
Denis Suárez,es ESP,MF,Celta Vigo,es La Liga,27,1994,31.3,61,29,20,33,8,25,82,30.5,57,32,4,28,16,77,11,0
Luis Suárez,uy URU,FW,Atlético Madrid,es La Liga,34,1987,20.4,8,5,2,4,2,2,10,20.0,8,8,1,7,1,9,14,0
Mario Suárez,es ESP,DF,Rayo Vallecano,es La Liga,34,1987,7.9,9,4,7,2,0,3,9,33.3,6,6,4,2,7,16,37,1
Isaac Success,ng NGA,FWMF,Udinese,it Serie A,25,1996,10.1,5,2,0,3,2,1,5,20.0,4,2,0,2,2,7,6,0
Niklas Süle,de GER,DF,Bayern Munich,de Bundesliga,25,1995,20.4,29,23,21,7,1,18,24,75.0,6,16,12,4,28,57,49,0
Kamaldeen Sulemana,gh GHA,MFFW,Rennes,fr Ligue 1,19,2002,11.3,23,12,7,9,7,10,17,58.8,7,10,1,9,4,27,5,0
Crysencio Summerville,nl NED,MFFW,Leeds United,eng Premier League,19,2001,1.4,5,3,1,1,3,2,3,66.7,1,2,0,2,2,7,0,0
Vladyslav Supriaha,ua UKR,FW,Sampdoria,it Serie A,21,2000,0.2,0,0,0,0,0,0,1,0.0,1,0,0,0,0,0,0,0
Suso,es ESP,FW,Sevilla,es La Liga,27,1993,4.3,4,3,1,3,0,3,13,23.1,10,4,0,4,0,4,0,0
Bosko Sutalo,hr CRO,DF,Hellas Verona,it Serie A,21,2000,10.2,20,13,11,6,3,8,16,50.0,8,10,5,5,17,37,39,0
Mattias Svanberg,se SWE,MF,Bologna,it Serie A,22,1999,28.5,39,15,15,16,8,16,54,29.6,38,31,9,22,28,67,34,0
Michael Svoboda,at AUT,DF,Venezia,it Serie A,22,1998,13.7,33,17,26,6,1,18,32,56.3,14,27,15,12,10,43,61,5
Abdoulaye Sylla,gn GUI,DF,Nantes,fr Ligue 1,21,2000,1.7,4,4,2,1,1,2,4,50.0,2,5,3,2,1,5,3,0
Mamadou Sylla,sn SEN,FWMF,Alavés,es La Liga,27,1994,4.4,2,2,0,1,1,0,1,0.0,1,0,0,0,1,3,5,0
Mamadou Sylla,sn SEN,FW,Rayo Vallecano,es La Liga,27,1994,2.8,1,1,1,0,0,0,1,0.0,1,2,0,2,4,5,3,0
Ádám Szalai,hu HUN,FW,Mainz 05,de Bundesliga,33,1987,2.9,3,2,0,2,1,0,2,0.0,2,2,0,2,0,3,0,0
Wojciech Szczęsny,pl POL,GK,Juventus,it Serie A,31,1990,33,1,1,1,0,0,1,2,50.0,1,0,0,0,0,1,8,1
Dominik Szoboszlai,hu HUN,MFFW,RB Leipzig,de Bundesliga,20,2000,17.1,17,12,5,9,3,8,27,29.6,19,30,3,27,10,27,15,0
Jakob Sørensen,dk DEN,MFDF,Norwich City,eng Premier League,23,1998,6.7,22,11,6,14,2,10,20,50.0,10,7,3,4,10,32,19,0
Alexander Sørloth,no NOR,FW,Real Sociedad,es La Liga,25,1995,19.6,20,7,4,10,6,7,17,41.2,10,14,1,13,4,24,15,0
Tachi,es ESP,DF,Alavés,es La Liga,23,1997,2.7,6,3,3,3,0,5,7,71.4,2,4,3,1,1,7,9,0
Jonathan Tah,de GER,DF,Leverkusen,de Bundesliga,25,1996,32,25,18,19,5,1,17,34,50.0,17,31,20,11,43,68,156,0
Waniss Taibi,fr FRA,MFFW,Angers,fr Ligue 1,19,2002,1.5,8,7,4,4,0,2,4,50.0,2,0,0,0,1,9,1,0
Flavien Tait,fr FRA,MF,Rennes,fr Ligue 1,28,1993,23.6,28,19,13,9,6,13,40,32.5,27,15,4,11,19,47,13,1
Adrien Tameze,cm CMR,MFDF,Hellas Verona,it Serie A,27,1994,28.6,52,29,24,21,7,20,59,33.9,39,40,5,35,52,104,41,0
Japhet Tanganga,eng ENG,DF,Tottenham,eng Premier League,22,1999,8.2,14,8,7,6,1,9,19,47.4,10,13,5,8,9,23,31,0
Renato Tapia,pe PER,MF,Celta Vigo,es La Liga,26,1995,15.7,50,31,15,31,4,20,50,40.0,30,21,5,16,28,78,43,0
Edmond Tapsoba,bf BFA,DF,Leverkusen,de Bundesliga,22,1999,20.2,35,17,24,10,1,20,32,62.5,12,27,15,12,29,64,72,1
Florian Tardieu,fr FRA,MF,Troyes,fr Ligue 1,29,1992,29.2,58,25,31,21,6,31,71,43.7,40,31,9,22,42,100,38,0
Matt Targett,eng ENG,DF,Aston Villa,eng Premier League,25,1995,15.9,34,18,28,5,1,24,45,53.3,21,16,9,7,23,57,35,0
Matt Targett,eng ENG,DF,Newcastle Utd,eng Premier League,25,1995,16,41,26,26,14,1,24,37,64.9,13,15,4,11,25,66,39,1
Oussama Targhalline,ma MAR,FW,Marseille,fr Ligue 1,19,2002,0.1,0,0,0,0,0,0,0,,0,0,0,0,0,0,0,0
James Tarkowski,eng ENG,DF,Burnley,eng Premier League,28,1992,34.5,65,45,47,17,1,33,47,70.2,14,75,61,14,48,113,186,4
Ciprian Tătărușanu,ro ROU,GK,Milan,it Serie A,35,1986,6,0,0,0,0,0,0,1,0.0,1,0,0,0,0,0,2,1
Niklas Tauer,de GER,DFMF,Mainz 05,de Bundesliga,20,2001,5.4,16,9,9,7,0,9,14,64.3,5,6,2,4,9,25,14,0
Nuno Tavares,pt POR,DF,Arsenal,eng Premier League,21,2000,13.1,21,14,10,7,4,8,18,44.4,10,15,5,10,9,30,33,1
Charlie Taylor,eng ENG,DF,Burnley,eng Premier League,27,1993,30.3,45,26,31,11,3,26,44,59.1,18,42,20,22,58,103,95,2
Loum Tchaouna,fr FRA,FWMF,Rennes,fr Ligue 1,17,2003,1,3,1,1,2,0,1,5,20.0,4,0,0,0,2,5,0,0
Warren Tchimbembé,cg CGO,MF,Metz,fr Ligue 1,23,1998,2.3,1,1,0,1,0,0,1,0.0,1,2,1,1,2,3,2,0
Aurélien Tchouaméni,fr FRA,MF,Monaco,fr Ligue 1,21,2000,32.5,86,45,33,49,4,29,55,52.7,26,39,7,32,101,187,34,0
Mathys Tel,fr FRA,FWMF,Rennes,fr Ligue 1,16,2005,0.6,2,1,1,1,0,0,0,,0,0,0,0,1,3,2,0
Jordan Tell,fr FRA,FW,Clermont Foot,fr Ligue 1,24,1997,3.2,5,5,0,3,2,1,4,25.0,3,3,0,3,0,5,1,0
Nathan Tella,eng ENG,MFFW,Southampton,eng Premier League,22,1999,8.9,13,9,5,7,1,6,18,33.3,12,13,0,13,6,19,9,0
Alex Telles,br BRA,DF,Manchester Utd,eng Premier League,28,1992,18.4,48,27,35,9,4,27,43,62.8,16,17,4,13,26,74,45,0
Cristian Tello,es ESP,FW,Betis,es La Liga,29,1991,9.1,17,11,6,7,4,13,31,41.9,18,9,0,9,10,27,6,0
Nahuel Tenaglia,ar ARG,DF,Alavés,es La Liga,25,1996,11.9,42,27,30,9,3,24,37,64.9,13,10,2,8,26,68,42,0
Marc Tenas,es ESP,FWMF,Alavés,es La Liga,20,2001,0.6,1,1,1,0,0,1,1,100.0,0,1,0,1,0,1,0,1
Marc-André ter Stegen,de GER,GK,Barcelona,es La Liga,29,1992,35,0,0,0,0,0,0,1,0.0,1,0,0,0,1,1,13,5
Filippo Terracciano,it ITA,DF,Hellas Verona,it Serie A,18,2003,0.1,0,0,0,0,0,0,0,,0,0,0,0,0,0,1,0
Pietro Terracciano,it ITA,GK,Fiorentina,it Serie A,31,1990,31.8,0,0,0,0,0,0,4,0.0,4,0,0,0,2,2,20,1
Martin Terrier,fr FRA,FWMF,Rennes,fr Ligue 1,24,1997,30.9,55,33,22,16,17,25,43,58.1,18,29,3,26,18,73,17,0
Aleksa Terzić,rs SRB,DF,Fiorentina,it Serie A,21,1999,3,8,5,3,3,2,4,7,57.1,3,7,0,7,4,12,5,0
Robert Tesche,de GER,MF,Bochum,de Bundesliga,34,1987,3.9,6,4,4,1,1,5,7,71.4,2,6,2,4,5,11,5,1
Tanner Tessmann,us USA,MF,Venezia,it Serie A,19,2001,7.6,11,5,4,6,1,5,14,35.7,9,19,9,10,5,16,22,0
Tetê,br BRA,FWMF,Lyon,fr Ligue 1,21,2000,6.5,10,5,4,5,1,3,13,23.1,10,4,0,4,3,13,1,0
Cedric Teuchert,de GER,MFFW,Union Berlin,de Bundesliga,24,1997,1.2,3,2,3,0,0,2,6,33.3,4,1,0,1,0,3,0,0
Arthur Theate,be BEL,DF,Bologna,it Serie A,21,2000,26.9,33,19,26,3,4,14,31,45.2,17,29,16,13,43,76,69,0
Jan Thielmann,de GER,MFFW,Köln,de Bundesliga,19,2002,13.2,24,16,6,12,6,8,23,34.8,15,23,2,21,10,34,11,0
Sada Thioub,sn SEN,FW,Angers,fr Ligue 1,26,1995,0,0,0,0,0,0,0,0,,0,0,0,0,0,0,0,0
Sada Thioub,sn SEN,DFMF,Saint-Étienne,fr Ligue 1,26,1995,10.6,13,8,5,8,0,6,14,42.9,8,9,0,9,10,23,8,0
Luke Thomas,eng ENG,DF,Leicester City,eng Premier League,20,2001,21.2,50,31,33,13,4,28,65,43.1,37,35,14,21,40,90,55,0
Romain Thomas,fr FRA,DF,Angers,fr Ligue 1,33,1988,28.5,49,37,28,21,0,30,57,52.6,27,35,19,16,44,93,126,0
Adrien Thomasson,fr FRA,MF,Strasbourg,fr Ligue 1,27,1993,26.5,64,31,18,27,19,30,93,32.3,63,56,4,52,29,93,16,1
Erik Thommy,de GER,FWMF,Stuttgart,de Bundesliga,26,1994,3,2,0,0,2,0,1,2,50.0,1,3,0,3,4,6,0,0
Dominic Thompson,eng ENG,DF,Brentford,eng Premier League,21,2000,1.6,1,0,1,0,0,0,1,0.0,1,2,2,0,2,3,3,0
Morten Thorsby,no NOR,MF,Sampdoria,it Serie A,25,1996,32.7,46,26,15,23,8,28,56,50.0,28,37,12,25,25,71,39,0
Thuler,br BRA,DF,Montpellier,fr Ligue 1,22,1999,9.5,21,12,17,4,0,8,15,53.3,7,9,7,2,9,30,30,0
Marcus Thuram,fr FRA,FW,M'Gladbach,de Bundesliga,23,1997,10.9,6,5,0,5,1,1,4,25.0,3,5,0,5,5,11,7,0
Khéphren Thuram-Ulie,fr FRA,MF,Nice,fr Ligue 1,20,2001,21.1,33,19,11,18,4,17,35,48.6,18,31,11,20,28,61,19,0
Alexis Tibidi,fr FRA,MFFW,Stuttgart,de Bundesliga,17,2003,4.3,7,3,1,3,3,3,4,75.0,1,4,0,4,3,10,2,0
Cheikh Tidiane Sabaly,sn SEN,FWMF,Metz,fr Ligue 1,22,1999,1.7,6,3,1,4,1,2,2,100.0,0,1,0,1,0,6,1,0
Youri Tielemans,be BEL,MF,Leicester City,eng Premier League,24,1997,29.2,74,38,23,45,6,42,100,42.0,58,47,13,34,21,95,41,3
Kieran Tierney,sct SCO,DF,Arsenal,eng Premier League,24,1997,21.3,18,14,11,7,0,10,11,90.9,1,23,5,18,15,33,54,0
Steffen Tigges,de GER,FWMF,Dortmund,de Bundesliga,23,1998,1.2,4,3,1,2,1,2,3,66.7,1,3,1,2,0,4,3,0
Malik Tillman,us USA,FWMF,Bayern Munich,de Bundesliga,19,2002,1.2,2,1,0,1,1,0,1,0.0,1,5,1,4,2,4,1,0
Timothy Tillman,de GER,MF,Greuther Fürth,de Bundesliga,22,1999,22.3,43,26,17,18,8,19,42,45.2,23,33,4,29,12,55,26,0
David Timor,es ESP,MF,Getafe,es La Liga,31,1989,3.8,1,1,1,0,0,0,3,0.0,3,3,2,1,1,2,4,1
Jean-Clair Todibo,fr FRA,DF,Nice,fr Ligue 1,21,1999,34.6,59,37,43,15,1,39,60,65.0,21,45,21,24,51,110,130,2
Umut Tohumcu,de GER,MF,Hoffenheim,de Bundesliga,16,2004,0.1,0,0,0,0,0,0,0,,0,0,0,0,0,0,0,0
Karl Toko Ekambi,cm CMR,FW,Lyon,fr Ligue 1,28,1992,25.5,13,7,4,6,3,4,21,19.0,17,26,0,26,20,33,5,0
Corentin Tolisso,fr FRA,MF,Bayern Munich,de Bundesliga,26,1994,7.8,11,5,1,9,1,7,17,41.2,10,5,1,4,9,20,10,0
Jeremy Toljan,de GER,DF,Sassuolo,it Serie A,26,1994,15.5,18,10,12,4,2,13,20,65.0,7,12,5,7,12,30,41,0
Rafael Tolói,it ITA,DF,Atalanta,it Serie A,30,1990,16,38,15,12,15,11,24,39,61.5,15,23,11,12,26,64,35,0
Raúl de Tomás,es ESP,FW,Espanyol,es La Liga,26,1994,32.4,15,11,6,7,2,6,17,35.3,11,12,3,9,6,21,42,1
Tiago Tomás,pt POR,FW,Stuttgart,de Bundesliga,19,2002,11.9,8,4,0,7,1,0,6,0.0,6,3,0,3,4,12,1,0
Takehiro Tomiyasu,jp JPN,DF,Arsenal,eng Premier League,22,1998,18.7,35,17,19,13,3,21,32,65.6,11,22,3,19,24,59,64,2
Takehiro Tomiyasu,jp JPN,DF,Bologna,it Serie A,22,1998,0.1,0,0,0,0,0,0,0,,0,1,0,1,1,1,0,0
James Tomkins,eng ENG,DF,Crystal Palace,eng Premier League,32,1989,6.1,8,3,6,2,0,6,8,75.0,2,8,8,0,4,12,18,0
Fikayo Tomori,eng ENG,DF,Milan,it Serie A,23,1997,30.2,73,44,36,34,3,18,26,69.2,8,37,23,14,45,118,84,1
Sandro Tonali,it ITA,MF,Milan,it Serie A,21,2000,28.9,54,37,23,25,6,21,41,51.2,20,26,8,18,34,88,19,0
Lorenzo Tonelli,it ITA,DF,Empoli,it Serie A,31,1990,9.7,17,9,11,4,2,6,13,46.2,7,14,8,6,19,36,28,2
Ivan Toney,eng ENG,FW,Brentford,eng Premier League,25,1996,32.3,33,21,5,20,8,12,38,31.6,26,16,2,14,14,47,44,1
Ernesto Torregrossa,ve VEN,FW,Sampdoria,it Serie A,29,1992,1.3,2,1,1,0,1,1,2,50.0,1,0,0,0,0,2,1,0
Lucas Torreira,uy URU,MF,Fiorentina,it Serie A,25,1996,24.4,37,29,13,21,3,18,40,45.0,22,18,1,17,26,63,18,0
Raúl Torrente,es ESP,DF,Granada,es La Liga,19,2001,14.2,31,21,18,11,2,16,29,55.2,13,14,9,5,12,43,69,0
Ferrán Torres,es ESP,FW,Manchester City,eng Premier League,21,2000,3.4,2,2,0,1,1,0,3,0.0,3,2,0,2,0,2,1,0
Ferrán Torres,es ESP,FW,Barcelona,es La Liga,21,2000,15.7,10,5,3,4,3,3,7,42.9,4,12,3,9,6,16,7,0
Óliver Torres,es ESP,MFFW,Sevilla,es La Liga,26,1994,11.2,22,12,8,7,7,8,25,32.0,17,10,1,9,6,28,4,0
Pau Torres,es ESP,DF,Villarreal,es La Liga,24,1997,31.7,32,19,23,7,2,18,25,72.0,7,32,23,9,19,51,105,2
Roberto Torres,es ESP,MFFW,Osasuna,es La Liga,32,1989,9,7,4,3,1,3,3,15,20.0,12,8,0,8,8,15,4,0
Lucas Torró,es ESP,MF,Osasuna,es La Liga,27,1994,30.3,71,40,25,38,8,29,57,50.9,28,32,11,21,47,118,55,0
Jordan Torunarigha,de GER,DF,Hertha BSC,de Bundesliga,23,1997,5.4,4,1,1,3,0,4,5,80.0,1,4,2,2,17,21,30,0
Cenk Tosun,tr TUR,MF,Everton,eng Premier League,30,1991,0.1,0,0,0,0,0,0,0,,0,0,0,0,0,0,0,0
Abdoulaye Touré,fr FRA,MF,Genoa,it Serie A,27,1994,4.8,12,4,3,8,1,5,11,45.5,6,6,1,5,4,16,6,0
Almamy Touré,ml MLI,DFMF,Eint Frankfurt,de Bundesliga,25,1996,5.6,12,9,8,3,1,4,17,23.5,13,10,3,7,5,17,19,0
Lucas Tousart,fr FRA,MF,Hertha BSC,de Bundesliga,24,1997,21.8,42,25,15,22,5,10,34,29.4,24,30,6,24,35,77,55,0
Yoann Touzghar,tn TUN,FW,Troyes,fr Ligue 1,34,1986,16.2,5,2,1,3,1,1,3,33.3,2,3,1,2,3,8,8,0
Andros Townsend,eng ENG,MFFW,Everton,eng Premier League,30,1991,16.2,31,17,15,6,10,15,40,37.5,25,28,2,26,14,45,6,1
Adama Traoré,es ESP,FWMF,Wolves,eng Premier League,25,1996,11.9,8,3,6,0,2,3,7,42.9,4,4,1,3,2,10,1,0
Adama Traoré,es ESP,FW,Barcelona,es La Liga,25,1996,4.2,4,2,0,3,1,3,5,60.0,2,2,0,2,4,8,3,1
Amadou Traore,fr FRA,FW,Bordeaux,fr Ligue 1,19,2002,0.2,0,0,0,0,0,0,0,,0,0,0,0,0,0,0,0
Bertrand Traoré,bf BFA,MFFW,Aston Villa,eng Premier League,25,1995,2.4,3,3,0,1,2,1,2,50.0,1,0,0,0,0,3,1,0
Boubacar Traoré,ml MLI,MF,Metz,fr Ligue 1,19,2001,19.2,43,26,18,23,2,10,39,25.6,29,29,5,24,25,68,11,1
Charles Traore,ml MLI,DF,Nantes,fr Ligue 1,29,1992,8,16,12,10,4,2,2,13,15.4,11,11,4,7,15,31,30,0
Hamari Traoré,ml MLI,DF,Rennes,fr Ligue 1,29,1992,32.1,63,36,25,26,12,41,59,69.5,18,29,8,21,37,100,81,1
Ismaël Traoré,ci CIV,DF,Angers,fr Ligue 1,34,1986,35.7,28,17,16,11,1,13,28,46.4,15,25,17,8,44,72,122,1
Kevin Trapp,de GER,GK,Eint Frankfurt,de Bundesliga,31,1990,32,0,0,0,0,0,0,1,0.0,1,0,0,0,1,1,13,2
Miguel Trauco,pe PER,DFMF,Saint-Étienne,fr Ligue 1,28,1992,12.4,25,18,16,8,1,12,22,54.5,10,13,4,9,23,48,17,0
Óscar Trejo,ar ARG,MF,Rayo Vallecano,es La Liga,33,1988,22.3,42,24,14,18,10,15,50,30.0,35,26,1,25,13,55,11,0
Trézéguet,eg EGY,FW,Aston Villa,eng Premier League,26,1994,0.1,0,0,0,0,0,0,0,,0,0,0,0,0,0,0,0
Manu Trigueros,es ESP,MFFW,Villarreal,es La Liga,29,1991,24.2,45,25,16,18,11,23,66,34.8,43,19,3,16,13,58,17,0
Simone Trimboli,it ITA,MF,Sampdoria,it Serie A,19,2002,0.7,2,1,2,0,0,2,2,100.0,0,0,0,0,2,4,0,0
Christopher Trimmel,at AUT,DFFW,Union Berlin,de Bundesliga,34,1987,22.1,49,30,25,19,5,26,45,57.8,19,20,3,17,34,83,75,0
Francisco Trincão,pt POR,FWMF,Wolves,eng Premier League,21,1999,14.8,28,15,9,13,6,3,19,15.8,16,17,1,16,12,40,1,1
Kieran Trippier,eng ENG,DF,Newcastle Utd,eng Premier League,30,1990,4.8,17,10,8,8,1,10,16,62.5,6,10,3,7,10,27,10,0
Kieran Trippier,eng ENG,DFFW,Atlético Madrid,es La Liga,30,1990,10.8,22,12,12,5,5,12,21,57.1,9,12,1,11,10,32,11,0
William Troost-Ekong,ng NGA,DF,Watford,eng Premier League,27,1993,15.4,18,9,11,6,1,10,15,66.7,5,24,14,10,7,25,82,1
Leandro Trossard,be BEL,FWMF,Brighton,eng Premier League,26,1994,31.2,34,20,12,9,13,4,31,12.9,27,33,4,29,15,49,10,0
Adrien Truffert,fr FRA,DF,Rennes,fr Ligue 1,19,2001,18.2,29,21,17,9,3,11,24,45.8,13,25,5,20,19,48,30,0
Philipp Tschauner,de GER,GK,RB Leipzig,de Bundesliga,35,1985,0,0,0,0,0,0,0,0,,0,0,0,0,0,0,0,0
Kostas Tsimikas,gr GRE,DF,Liverpool,eng Premier League,25,1996,9.7,27,12,12,8,7,12,16,75.0,4,6,2,4,10,37,22,2
Axel Tuanzebe,eng ENG,DF,Aston Villa,eng Premier League,23,1997,5.6,5,3,3,2,0,2,5,40.0,3,5,4,1,5,10,12,1
Axel Tuanzebe,eng ENG,DF,Napoli,it Serie A,23,1997,0.1,0,0,0,0,0,0,0,,0,1,1,0,0,0,0,0
Ozan Tufan,tr TUR,MF,Watford,eng Premier League,26,1995,3.7,3,2,1,1,1,1,5,20.0,4,2,0,2,2,5,4,0
Beñat Turrientes,es ESP,MF,Real Sociedad,es La Liga,19,2002,2.3,0,0,0,0,0,0,4,0.0,4,1,0,1,2,2,2,0
Tuta,br BRA,DF,Eint Frankfurt,de Bundesliga,22,1999,24.3,46,28,20,22,4,26,47,55.3,21,43,15,28,41,87,76,1
Christos Tzolis,gr GRE,FWMF,Norwich City,eng Premier League,19,2002,3.7,5,3,3,1,1,2,9,22.2,7,3,0,3,1,6,1,0
Iyenoma Udogie,it ITA,DF,Udinese,it Serie A,18,2002,27.5,64,40,30,27,7,33,60,55.0,27,39,6,33,27,91,42,0
Matthieu Udol,fr FRA,DF,Metz,fr Ligue 1,25,1996,11.2,23,14,11,10,2,12,18,66.7,6,20,7,13,31,54,29,1
Ike Ugbo,ca CAN,FW,Troyes,fr Ligue 1,22,1998,9,3,1,0,1,2,0,1,0.0,1,4,1,3,2,5,1,0
Chimuanya Ugochukwu,fr FRA,MF,Rennes,fr Ligue 1,17,2004,4.5,13,9,5,5,3,9,19,47.4,10,7,2,5,4,17,2,0
Hwang Ui-jo,kr KOR,FW,Bordeaux,fr Ligue 1,28,1992,27.9,10,4,4,4,2,4,13,30.8,9,9,1,8,5,15,18,0
Anthony Ujah,ng NGA,FWMF,Union Berlin,de Bundesliga,30,1990,0.4,0,0,0,0,0,0,0,,0,0,0,0,0,0,0,0
Maximilian Ullmann,at AUT,DF,Venezia,it Serie A,25,1996,2.7,0,0,0,0,0,0,1,0.0,1,4,0,4,2,2,7,0
Sven Ulreich,de GER,GK,Bayern Munich,de Bundesliga,32,1988,6,0,0,0,0,0,0,0,,0,0,0,0,0,0,1,0
Samuel Umtiti,fr FRA,DF,Barcelona,es La Liga,27,1993,1,2,2,2,0,0,1,2,50.0,1,1,1,0,0,2,4,0
Enes Ünal,tr TUR,FW,Getafe,es La Liga,24,1997,31.1,37,22,2,18,17,5,42,11.9,37,25,5,20,5,42,36,0
Cengiz Ünder,tr TUR,FWMF,Marseille,fr Ligue 1,24,1997,24.4,18,13,5,6,7,5,18,27.8,13,13,2,11,14,32,9,0
Dayot Upamecano,fr FRA,DF,Bayern Munich,de Bundesliga,22,1998,24.6,66,42,42,21,3,24,36,66.7,12,20,10,10,32,98,71,6
Benjamin Uphoff,de GER,GK,Freiburg,de Bundesliga,27,1993,2,0,0,0,0,0,0,0,,0,0,0,0,0,0,2,2
Kacper Urbanski,pl POL,MF,Bologna,it Serie A,16,2004,0.5,3,2,1,2,0,2,2,100.0,0,2,0,2,0,3,0,0
Jere Uronen,fi FIN,DF,Brest,fr Ligue 1,27,1994,9.8,28,15,15,10,3,14,24,58.3,10,12,3,9,16,44,21,0
Mark Uth,de GER,MFFW,Köln,de Bundesliga,29,1991,22.5,32,20,9,14,9,15,49,30.6,34,27,1,26,14,46,13,0
Myrto Uzuni,al ALB,FWMF,Granada,es La Liga,26,1995,9.5,7,4,6,1,0,0,2,0.0,2,13,1,12,10,17,7,0
Antonio Vacca,it ITA,MF,Venezia,it Serie A,31,1990,11.8,36,20,24,10,2,14,36,38.9,22,16,8,8,20,56,16,0
Álvaro Vadillo,es ESP,DFMF,Espanyol,es La Liga,26,1994,0.1,1,1,1,0,0,1,2,50.0,1,0,0,0,0,1,1,0
Óscar Valentín,es ESP,MF,Rayo Vallecano,es La Liga,26,1994,28.5,102,53,46,51,5,44,105,41.9,61,56,10,46,39,141,43,0
Germán Valera,es ESP,FW,Real Sociedad,es La Liga,19,2002,0.6,3,2,3,0,0,1,1,100.0,0,0,0,0,0,3,1,0
Yan Valery,tn TUN,DF,Southampton,eng Premier League,22,1999,4.1,8,6,4,3,1,4,9,44.4,5,6,3,3,6,14,19,1
Martin Valjent,sk SVK,DF,Mallorca,es La Liga,25,1995,35.3,31,19,18,12,1,13,24,54.2,11,34,26,8,31,62,173,1
Jesús Vallejo,es ESP,DF,Real Madrid,es La Liga,24,1997,3.8,7,5,7,0,0,5,6,83.3,1,9,8,1,6,13,16,0
Manu Vallejo,es ESP,MFFW,Alavés,es La Liga,24,1997,4.1,8,2,1,4,3,4,13,30.8,9,7,0,7,0,8,4,0
Manu Vallejo,es ESP,FWMF,Valencia,es La Liga,24,1997,1.1,2,1,1,1,0,0,1,0.0,1,0,0,0,0,2,1,0
Federico Valverde,uy URU,MF,Real Madrid,es La Liga,23,1998,20.4,36,16,11,16,9,12,31,38.7,19,23,5,18,24,60,12,0
Virgil van Dijk,nl NED,DF,Liverpool,eng Premier League,30,1991,34,16,10,11,5,0,11,16,68.8,5,21,14,7,31,47,109,0
Vanderson,br BRA,FWDF,Monaco,fr Ligue 1,20,2001,12.4,35,19,10,19,6,15,23,65.2,8,17,4,13,13,48,12,0
Zinho Vanheusden,be BEL,DF,Genoa,it Serie A,22,1999,11,18,6,12,5,1,8,14,57.1,6,19,14,5,23,41,42,0
Jonathan Varane,fr FRA,MF,Lens,fr Ligue 1,19,2001,0,0,0,0,0,0,0,0,,0,0,0,0,0,0,0,0
Raphaël Varane,fr FRA,DF,Manchester Utd,eng Premier League,28,1993,20.3,28,19,21,6,1,10,22,45.5,12,18,9,9,18,46,82,1
Jamie Vardy,eng ENG,FW,Leicester City,eng Premier League,34,1987,20.1,6,5,0,4,2,1,7,14.3,6,9,0,9,1,7,17,0
Ruben Vargas,ch SUI,MFFW,Augsburg,de Bundesliga,22,1998,22,28,21,7,14,7,11,30,36.7,19,9,1,8,16,44,13,0
Sebastian Vasiliadis,gr GRE,MF,Arminia,de Bundesliga,23,1997,13.3,31,17,12,15,4,15,42,35.7,27,15,2,13,25,56,31,1
Johan Vásquez,mx MEX,DF,Genoa,it Serie A,22,1998,25.3,79,46,44,32,3,48,75,64.0,27,32,10,22,42,121,85,0
Denis Vavro,sk SVK,DF,Lazio,it Serie A,25,1996,0.1,0,0,0,0,0,0,0,,0,0,0,0,0,0,0,0
José Luis García Vayá,es ESP,MF,Levante,es La Liga,22,1998,22.4,46,27,10,31,5,16,41,39.0,25,24,5,19,38,84,30,0
Jesus Vazquez,es ESP,DF,Valencia,es La Liga,18,2003,9,24,13,10,8,6,10,22,45.5,12,16,3,13,9,33,19,0
Kevin Vázquez,es ESP,DF,Celta Vigo,es La Liga,28,1993,14.8,34,24,12,13,9,14,28,50.0,14,20,7,13,36,70,34,0
Lucas Vázquez,es ESP,DF,Real Madrid,es La Liga,30,1991,20.4,43,22,24,9,10,17,35,48.6,18,25,7,18,20,63,41,1
Matías Vecino,uy URU,MF,Inter,it Serie A,29,1991,4.2,7,5,2,3,2,3,9,33.3,6,10,1,9,4,11,7,0
Gabriel Veiga,es ESP,MF,Celta Vigo,es La Liga,19,2002,1.2,5,4,0,4,1,3,12,25.0,9,2,0,2,4,9,1,0
Miguel Veloso,pt POR,MF,Hellas Verona,it Serie A,35,1986,14.9,23,15,4,17,2,10,16,62.5,6,18,5,13,11,34,18,1
Joël Veltman,nl NED,DF,Brighton,eng Premier League,29,1992,31.9,74,48,47,21,6,21,53,39.6,32,46,16,30,45,119,89,0
Mickey van de Ven,nl NED,DF,Wolfsburg,de Bundesliga,20,2001,2.1,4,4,3,1,0,0,1,0.0,1,4,1,3,2,6,8,0
Unai Vencedor Paris,es ESP,MF,Athletic Club,es La Liga,20,2000,26.5,26,11,11,9,6,8,42,19.0,34,31,13,18,19,45,22,0
Lorenzo Venuti,it ITA,DF,Fiorentina,it Serie A,26,1995,17.5,25,10,13,10,2,14,24,58.3,10,13,4,9,5,30,27,0
Daniele Verde,it ITA,FWMF,Spezia,it Serie A,25,1996,21.7,11,4,8,2,1,9,20,45.0,11,17,2,15,18,29,8,0
Simone Verdi,it ITA,MFFW,Torino,it Serie A,29,1992,0.5,1,1,0,1,0,0,0,,0,0,0,0,0,1,0,0
Simone Verdi,it ITA,FWMF,Salernitana,it Serie A,29,1992,9.2,12,8,5,2,5,9,20,45.0,11,4,0,4,3,15,1,0
Gonzalo Verdú,es ESP,DF,Elche,es La Liga,32,1988,15.5,19,9,15,4,0,8,16,50.0,8,20,14,6,13,32,59,1
Jordan Veretout,fr FRA,MF,Roma,it Serie A,28,1993,25.8,34,25,20,12,2,15,39,38.5,24,12,1,11,27,61,22,1
Edoardo Vergani,it ITA,FWMF,Salernitana,it Serie A,20,2001,1.1,2,2,2,0,0,0,0,,0,2,2,0,0,2,2,0
Vincent Vermeij,nl NED,MF,Freiburg,de Bundesliga,26,1994,0,0,0,0,0,0,0,0,,0,1,0,1,0,0,0,0
Marco Verratti,it ITA,MF,Paris S-G,fr Ligue 1,28,1992,21.5,60,40,16,30,14,32,64,50.0,32,36,10,26,18,78,14,2
Valerio Verre,it ITA,MFFW,Sampdoria,it Serie A,27,1994,4.7,7,5,1,4,2,4,9,44.4,5,7,0,7,0,7,5,0
Valerio Verre,it ITA,MF,Empoli,it Serie A,27,1994,3.4,4,2,3,1,0,2,7,28.6,5,2,0,2,1,5,0,0
Freddie Veseli,al ALB,DF,Salernitana,it Serie A,28,1992,6.6,7,2,4,3,0,5,6,83.3,1,10,5,5,4,11,19,0
Mikel Vesga,es ESP,MF,Athletic Club,es La Liga,28,1993,15.1,27,14,7,18,2,11,31,35.5,20,16,5,11,20,47,34,2
Jannik Vestergaard,dk DEN,DF,Leicester City,eng Premier League,28,1992,6.3,15,10,12,3,0,8,15,53.3,7,10,8,2,7,22,36,0
Rúben Vezo,pt POR,DF,Levante,es La Liga,27,1994,26.9,41,29,28,12,1,26,41,63.4,15,41,25,16,36,77,105,1
Guglielmo Vicario,it ITA,GK,Empoli,it Serie A,24,1996,38,1,1,1,0,0,1,1,100.0,0,1,0,1,1,2,21,1
Aleix Vidal,es ESP,DFMF,Espanyol,es La Liga,31,1989,21.1,31,25,17,9,5,19,39,48.7,20,19,6,13,25,56,35,2
Arturo Vidal,cl CHI,MF,Inter,it Serie A,34,1987,8.2,26,10,16,9,1,9,26,34.6,17,13,5,8,7,33,7,1
Nacho Vidal,es ESP,DF,Osasuna,es La Liga,26,1995,32.2,83,47,49,25,9,39,77,50.6,38,32,14,18,58,141,79,0
Gabriel Vidovic,hr CRO,FWMF,Bayern Munich,de Bundesliga,17,2003,0.4,0,0,0,0,0,0,0,,0,0,0,0,0,0,0,0
Ronaldo Vieira,gw GNB,MF,Sampdoria,it Serie A,23,1998,5.5,,6,,,,,,,,,,,5,,,
Nick Viergever,nl NED,DF,Greuther Fürth,de Bundesliga,31,1989,23.7,32,23,25,7,0,24,34,70.6,10,31,22,9,37,69,119,1
Luca Vignali,it ITA,DFMF,Spezia,it Serie A,25,1996,0.9,1,1,0,1,0,0,3,0.0,3,0,0,0,1,2,1,0
Emanuel Vignato,it ITA,MFDF,Bologna,it Serie A,20,2000,6.6,12,7,5,7,0,6,13,46.2,7,2,0,2,2,14,5,0
Dídac Vilà,es ESP,DFMF,Espanyol,es La Liga,32,1989,2.3,7,5,2,5,0,4,9,44.4,5,2,1,1,3,10,8,0
Tonny Vilhena,nl NED,MFFW,Espanyol,es La Liga,26,1995,10.3,16,6,7,8,1,7,21,33.3,14,10,2,8,8,24,17,0
Daniel Villahermosa,es ESP,MF,Espanyol,es La Liga,20,2001,0.3,0,0,0,0,0,0,0,,0,0,0,0,0,0,1,0
Asier Villalibre,es ESP,FW,Athletic Club,es La Liga,23,1997,6.1,4,3,2,1,1,1,2,50.0,1,3,1,2,1,5,7,0
Gonzalo Villar,es ESP,MF,Getafe,es La Liga,23,1998,3.3,5,3,4,1,0,2,5,40.0,3,4,1,3,1,6,1,0
Matías Viña,uy URU,DFFW,Roma,it Serie A,23,1997,17.4,46,30,27,14,5,29,59,49.2,30,26,3,23,25,71,33,0
Nicolas Viola,it ITA,MF,Bologna,it Serie A,31,1989,1.1,2,2,1,1,0,1,2,50.0,1,1,1,0,0,2,1,0
Mattia Viti,it ITA,DF,Empoli,it Serie A,19,2002,16.6,28,16,16,9,3,15,24,62.5,9,28,25,3,29,57,69,1
Vitolo,es ESP,MF,Getafe,es La Liga,31,1989,2.5,3,2,1,1,1,2,5,40.0,3,3,0,3,1,4,1,0
Daniel Vivian,es ESP,DF,Athletic Club,es La Liga,22,1999,22.1,32,21,24,7,1,17,24,70.8,7,20,15,5,26,58,107,1
Dušan Vlahović,rs SRB,FW,Fiorentina,it Serie A,21,2000,20.6,5,0,0,2,3,2,11,18.2,9,6,2,4,1,6,16,0
Dušan Vlahović,rs SRB,FW,Juventus,it Serie A,21,2000,12,0,0,0,0,0,0,4,0.0,4,3,0,3,0,0,7,0
Nikola Vlašić,hr CRO,FWMF,West Ham,eng Premier League,23,1997,6.2,11,7,4,6,1,5,20,25.0,15,4,0,4,2,13,1,0
Andreas Voglsammer,de GER,FWMF,Union Berlin,de Bundesliga,29,1992,9.8,14,9,8,3,3,6,14,42.9,8,9,2,7,2,16,7,0
Kevin Vogt,de GER,DF,Hoffenheim,de Bundesliga,29,1991,28.5,21,12,15,6,0,11,21,52.4,10,18,7,11,13,34,101,1
Mërgim Vojvoda,xk KVX,DF,Torino,it Serie A,26,1995,22,38,23,23,11,4,20,36,55.6,16,27,8,19,20,58,51,0
Kevin Volland,de GER,MFFW,Monaco,fr Ligue 1,29,1992,27.1,24,10,2,18,4,6,31,19.4,25,20,0,20,3,27,9,0
Cristian Volpato,it ITA,FWMF,Roma,it Serie A,17,2003,0.4,1,1,0,0,1,1,1,100.0,0,0,0,0,0,1,0,0
Aster Vranckx,be BEL,MF,Wolfsburg,de Bundesliga,18,2002,12.7,34,13,14,16,4,14,26,53.8,12,19,7,12,13,47,16,0
Stefan de Vrij,nl NED,DF,Inter,it Serie A,29,1992,26.8,38,29,22,16,0,12,17,70.6,5,17,8,9,32,70,52,0
Šime Vrsaljko,hr CRO,DF,Atlético Madrid,es La Liga,29,1992,10.2,27,17,14,12,1,12,20,60.0,8,10,1,9,12,39,30,0
Nikola Vukčević,me MNE,MF,Levante,es La Liga,29,1991,1.3,3,2,2,1,0,0,1,0.0,1,2,0,2,2,5,1,0
Matěj Vydra,cz CZE,FW,Burnley,eng Premier League,29,1992,7.5,12,7,3,4,5,3,7,42.9,4,5,1,4,0,12,9,0
Walace,br BRA,MF,Udinese,it Serie A,26,1995,33,83,49,37,38,8,50,113,44.2,63,51,5,46,54,137,32,1
Theo Walcott,eng ENG,MFFW,Southampton,eng Premier League,32,1989,4.2,4,2,2,0,2,1,5,20.0,4,3,0,3,5,9,2,0
Luca Waldschmidt,de GER,MFFW,Wolfsburg,de Bundesliga,25,1996,8,9,1,3,5,1,5,13,38.5,8,5,0,5,8,17,3,0
Kyle Walker,eng ENG,DF,Manchester City,eng Premier League,31,1990,19.5,15,6,7,7,1,8,17,47.1,9,14,4,10,14,29,16,1
Kyle Walker-Peters,eng ENG,DF,Southampton,eng Premier League,24,1997,29.3,57,33,28,21,8,26,38,68.4,12,29,8,21,37,94,53,1
Sebastian Walukiewicz,pl POL,DF,Cagliari,it Serie A,21,2000,3.4,9,5,7,2,0,3,5,60.0,2,5,2,3,7,16,14,0
Aaron Wan-Bissaka,eng ENG,DF,Manchester Utd,eng Premier League,23,1997,19.9,49,36,25,18,6,14,20,70.0,6,24,14,10,34,83,41,2
Paul Wanner,de GER,FWMF,Bayern Munich,de Bundesliga,15,2005,0.4,2,2,0,2,0,1,1,100.0,0,0,0,0,0,2,0,0
Danny Ward,wls WAL,GK,Leicester City,eng Premier League,28,1993,1,0,0,0,0,0,0,0,,0,0,0,0,0,0,1,0
Joel Ward,eng ENG,DF,Crystal Palace,eng Premier League,31,1989,27.6,44,26,30,11,3,30,57,52.6,27,24,11,13,32,76,107,1
James Ward-Prowse,eng ENG,MF,Southampton,eng Premier League,26,1994,35.7,41,24,12,24,5,19,70,27.1,51,43,15,28,40,81,45,1
Magnus Warming,dk DEN,MFFW,Torino,it Serie A,21,2000,0.6,1,1,0,1,0,0,0,,0,2,0,2,0,1,0,0
Daniel Wass,dk DEN,DFFW,Atlético Madrid,es La Liga,32,1989,0.5,0,0,0,0,0,0,0,,0,0,0,0,0,0,3,0
Daniel Wass,dk DEN,MF,Valencia,es La Liga,32,1989,17.6,23,13,6,14,3,8,31,25.8,23,13,2,11,13,36,19,0
Ollie Watkins,eng ENG,FW,Aston Villa,eng Premier League,25,1995,32.8,17,13,2,7,8,2,15,13.3,13,25,3,22,12,29,27,0
Timothy Weah,us USA,MFFW,Lille,fr Ligue 1,21,2000,18,19,7,8,8,3,10,20,50.0,10,16,1,15,10,29,7,0
Adam Webster,eng ENG,DF,Brighton,eng Premier League,26,1995,15.9,26,8,17,7,2,13,20,65.0,7,25,17,8,17,43,66,2
Wout Weghorst,nl NED,FW,Burnley,eng Premier League,28,1992,16.1,17,9,3,9,5,6,19,31.6,13,16,5,11,6,23,13,0
Wout Weghorst,nl NED,FW,Wolfsburg,de Bundesliga,28,1992,17.3,13,7,3,3,7,7,17,41.2,10,10,3,7,2,15,11,1
Noah Weißhaupt,de GER,MFFW,Freiburg,de Bundesliga,19,2001,1.1,1,1,1,0,0,1,2,50.0,1,2,0,2,1,2,1,1
Danny Welbeck,eng ENG,FWMF,Brighton,eng Premier League,30,1990,16.4,14,7,2,8,4,3,10,30.0,7,18,2,16,5,19,18,0
Timo Werner,de GER,FWMF,Chelsea,eng Premier League,25,1996,14.3,8,4,3,3,2,2,20,10.0,18,9,0,9,2,10,4,0
Ashley Westwood,eng ENG,MF,Burnley,eng Premier League,31,1990,25.4,21,12,8,12,1,10,31,32.3,21,21,9,12,30,51,16,1
Ben White,eng ENG,DF,Arsenal,eng Premier League,23,1997,32,44,23,30,8,6,28,45,62.2,17,42,24,18,42,86,102,0
Silvan Widmer,ch SUI,DF,Mainz 05,de Bundesliga,28,1993,32.4,60,28,32,20,8,36,61,59.0,25,44,16,28,43,103,59,2
Georginio Wijnaldum,nl NED,MF,Paris S-G,fr Ligue 1,30,1990,18.4,15,9,2,12,1,11,19,57.9,8,13,3,10,9,24,7,0
Jetro Willems,nl NED,DF,Greuther Fürth,de Bundesliga,27,1994,17.8,30,15,18,10,2,15,26,57.7,11,15,3,12,14,44,42,0
Brandon Williams,eng ENG,DF,Norwich City,eng Premier League,20,2000,23.6,55,37,35,18,2,36,64,56.3,28,26,6,20,44,99,50,0
Iñaki Williams,gh GHA,FW,Athletic Club,es La Liga,27,1994,30.9,14,5,1,6,7,5,17,29.4,12,18,3,15,3,17,20,0
Neco Williams,wls WAL,DF,Liverpool,eng Premier League,20,2001,0.1,0,0,0,0,0,0,0,,0,0,0,0,0,0,0,0
Nico Williams,es ESP,MF,Athletic Club,es La Liga,19,2002,14.9,20,10,6,11,3,10,31,32.3,21,18,2,16,5,25,9,0
Joe Willock,eng ENG,MF,Newcastle Utd,eng Premier League,21,1999,22.6,64,37,30,28,6,29,68,42.6,39,37,6,31,21,85,10,1
Callum Wilson,eng ENG,FW,Newcastle Utd,eng Premier League,29,1992,15.4,9,8,1,5,3,1,4,25.0,3,7,2,5,3,12,10,0
Patrick Wimmer,at AUT,FWMF,Arminia,de Bundesliga,20,2001,22.8,53,31,13,31,9,22,61,36.1,39,30,1,29,27,80,13,0
Jonas Wind,dk DEN,FWMF,Wolfsburg,de Bundesliga,22,1999,13.1,10,6,1,7,2,1,4,25.0,3,8,3,5,6,16,13,0
Marten Winkler,de GER,MF,Hertha BSC,de Bundesliga,18,2002,0.3,0,0,0,0,0,0,0,,0,0,0,0,0,0,0,0
Harry Winks,eng ENG,MF,Tottenham,eng Premier League,25,1996,10.1,15,10,4,9,2,8,21,38.1,13,14,3,11,16,31,10,2
Frederik Winther,dk DEN,DF,Augsburg,de Bundesliga,20,2001,3.6,7,2,7,0,0,5,6,83.3,1,4,1,3,8,15,21,0
Florian Wirtz,de GER,MFFW,Leverkusen,de Bundesliga,18,2003,20.6,25,10,6,16,3,10,28,35.7,18,12,1,11,13,38,4,0
Yoane Wissa,cd COD,FW,Brentford,eng Premier League,24,1996,14.3,12,6,5,4,3,1,16,6.3,15,12,5,7,8,20,6,0
Axel Witsel,be BEL,MFDF,Dortmund,de Bundesliga,32,1989,21.6,42,27,12,23,7,18,30,60.0,12,24,9,15,27,69,38,0
Hannes Wolf,at AUT,FWMF,M'Gladbach,de Bundesliga,22,1999,3.4,23,12,4,13,6,10,20,50.0,10,10,0,10,2,25,1,0
Marius Wolf,de GER,DFFW,Dortmund,de Bundesliga,26,1995,14.7,26,10,13,9,4,12,24,50.0,12,14,1,13,13,39,8,0
Luca Wollschläger,de GER,FWMF,Hertha BSC,de Bundesliga,18,2003,0.2,1,1,0,1,0,0,1,0.0,1,0,0,0,0,1,0,0
Jeong Woo-yeong,kr KOR,FWMF,Freiburg,de Bundesliga,21,1999,19.8,15,9,6,7,2,5,15,33.3,10,8,1,7,7,22,11,0
Chris Wood,nz NZL,FW,Burnley,eng Premier League,29,1991,15.2,7,5,0,3,4,3,10,30.0,7,13,4,9,0,7,3,0
Chris Wood,nz NZL,FW,Newcastle Utd,eng Premier League,29,1991,14.7,2,0,1,1,0,1,2,50.0,1,5,2,3,2,4,9,0
Freddie Woodman,eng ENG,GK,Newcastle Utd,eng Premier League,24,1997,4,0,0,0,0,0,0,0,,0,0,0,0,0,0,0,1
Christopher Wooh,cm CMR,DF,Lens,fr Ligue 1,19,2001,11.7,29,11,20,8,1,11,18,61.1,7,21,14,7,21,50,40,1
Joscha Wosz,de GER,DF,RB Leipzig,de Bundesliga,19,2002,0.1,0,0,0,0,0,0,0,,0,0,0,0,0,0,0,0
Xeka,pt POR,MF,Lille,fr Ligue 1,26,1994,18,47,27,18,24,5,27,56,48.2,29,23,3,20,24,71,26,1
Granit Xhaka,ch SUI,MFDF,Arsenal,eng Premier League,28,1992,25.9,32,18,16,12,4,16,41,39.0,25,21,6,15,21,53,31,0
Sekou Yansané,gn GUI,FW,Paris S-G,fr Ligue 1,18,2003,0.2,0,0,0,0,0,0,1,0.0,1,0,0,0,0,0,1,0
Andriy Yarmolenko,ua UKR,FWMF,West Ham,eng Premier League,31,1989,3.5,4,2,2,2,0,2,8,25.0,6,4,2,2,0,4,2,0
Yusuf Yazıcı,tr TUR,MFFW,Lille,fr Ligue 1,24,1997,5.7,10,5,3,6,1,1,9,11.1,8,4,0,4,2,12,1,0
Kelvin Yeboah,it ITA,FWMF,Genoa,it Serie A,21,2000,9.4,14,7,5,7,2,9,19,47.4,10,22,1,21,1,15,7,0
Gerard Yepes,es ESP,MFDF,Sampdoria,it Serie A,18,2002,0.2,1,0,0,1,0,1,1,100.0,0,1,0,1,0,1,0,0
Burak Yılmaz,tr TUR,FW,Lille,fr Ligue 1,36,1985,24.6,7,2,0,2,5,2,17,11.8,15,8,1,7,2,9,11,0
Okay Yokuşlu,tr TUR,DFMF,Getafe,es La Liga,27,1994,5.2,9,8,6,2,1,5,5,100.0,0,7,5,2,5,14,17,0
Okay Yokuşlu,tr TUR,DFMF,Celta Vigo,es La Liga,27,1994,1.6,4,1,2,1,1,2,3,66.7,1,2,1,1,2,6,6,0
Leny Yoro,fr FRA,MF,Lille,fr Ligue 1,15,2005,0.1,1,0,0,1,0,0,0,,0,1,0,1,0,1,0,0
Maya Yoshida,jp JPN,DF,Sampdoria,it Serie A,32,1988,20.3,17,10,8,9,0,8,15,53.3,7,27,20,7,28,45,72,1
Ashley Young,eng ENG,DFFW,Aston Villa,eng Premier League,36,1985,13.9,18,6,9,6,3,11,16,68.8,5,10,4,6,13,31,25,1
Nathan Young-Coombes,eng ENG,MF,Brentford,eng Premier League,18,2003,0,0,0,0,0,0,0,0,,0,0,0,0,0,0,0,0
Zaydou Youssouf,fr FRA,MF,Saint-Étienne,fr Ligue 1,22,1999,17.3,48,26,21,25,2,14,34,41.2,20,11,3,8,17,65,13,0
Mattia Zaccagni,it ITA,MF,Hellas Verona,it Serie A,26,1995,2,3,1,1,0,2,1,2,50.0,1,1,0,1,4,7,0,0
Mattia Zaccagni,it ITA,FW,Lazio,it Serie A,26,1995,20.8,33,16,10,13,10,11,19,57.9,8,17,2,15,20,53,5,0
Dan-Axel Zagadou,fr FRA,DF,Dortmund,de Bundesliga,22,1999,10.6,13,7,11,1,1,7,10,70.0,3,14,4,10,15,28,38,2
Wilfried Zaha,ci CIV,FW,Crystal Palace,eng Premier League,28,1992,30.7,40,20,14,15,11,10,31,32.3,21,28,0,28,5,45,5,0
Denis Zakaria,ch SUI,MF,Juventus,it Serie A,24,1996,6.6,11,7,3,6,2,3,11,27.3,8,16,3,13,11,22,7,0
Denis Zakaria,ch SUI,MFDF,M'Gladbach,de Bundesliga,24,1996,15.5,23,14,9,10,4,12,35,34.3,23,25,5,20,19,42,22,1
Joseba Zaldúa,es ESP,DF,Real Sociedad,es La Liga,29,1992,13,31,22,20,8,3,16,22,72.7,6,14,4,10,13,44,35,0
Nicola Zalewski,pl POL,DF,Roma,it Serie A,19,2002,8.8,32,19,17,11,4,21,35,60.0,14,18,1,17,16,48,4,0
Andre-Frank Zambo Anguissa,cm CMR,MF,Napoli,it Serie A,25,1995,21.4,50,26,24,17,9,25,51,49.0,26,31,5,26,24,74,33,1
Nicolò Zaniolo,it ITA,FWMF,Roma,it Serie A,22,1999,21.9,24,15,0,15,9,6,28,21.4,22,19,0,19,7,31,6,0
Alessandro Zanoli,it ITA,DF,Napoli,it Serie A,20,2000,5.1,10,7,6,3,1,3,5,60.0,2,2,1,1,4,14,16,0
Mattia Zanotti,it ITA,DF,Inter,it Serie A,18,2003,0.1,1,0,1,0,0,0,1,0.0,1,0,0,0,0,1,0,0
Duván Zapata,co COL,FW,Atalanta,it Serie A,30,1991,19.1,6,2,0,4,2,4,8,50.0,4,8,1,7,3,9,5,0
Gabriele Zappa,it ITA,DF,Cagliari,it Serie A,21,1999,12.7,21,9,12,6,3,6,24,25.0,18,15,5,10,14,35,28,0
Davide Zappacosta,it ITA,DF,Atalanta,it Serie A,29,1992,26.1,32,22,12,13,7,19,37,51.4,18,32,2,30,12,44,22,0
Oier Zarraga,es ESP,MF,Athletic Club,es La Liga,22,1999,13,13,5,4,7,2,3,28,10.7,25,17,10,7,19,32,10,0
Simone Zaza,it ITA,FWDF,Torino,it Serie A,30,1991,1.4,2,2,1,1,0,1,1,100.0,0,3,0,3,0,2,3,0
Akim Zedadka,dz ALG,DF,Clermont Foot,fr Ligue 1,26,1995,37.1,72,44,34,29,9,37,71,52.1,34,32,8,24,58,130,48,0
Deyovaisio Zeefuik,nl NED,DF,Hertha BSC,de Bundesliga,23,1998,6.3,11,10,6,4,1,6,12,50.0,6,12,4,8,11,22,21,1
Marvin Zeegelaar,nl NED,DF,Udinese,it Serie A,30,1990,7.1,15,11,6,8,1,5,14,35.7,9,12,4,8,12,27,22,1
Arber Zeneli,xk KVX,FW,Reims,fr Ligue 1,26,1995,4.5,1,0,0,0,1,1,5,20.0,4,0,0,0,1,2,1,0
Robin Zentner,de GER,GK,Mainz 05,de Bundesliga,26,1994,32,2,2,2,0,0,2,2,100.0,0,0,0,0,2,4,21,1
Andi Zeqiri,ch SUI,FWMF,Augsburg,de Bundesliga,22,1999,11.3,14,7,3,5,6,3,12,25.0,9,10,1,9,2,16,12,0
Mehdi Zerkane,dz ALG,MFDF,Bordeaux,fr Ligue 1,22,1999,0.9,0,0,0,0,0,0,1,0.0,1,1,1,0,2,2,0,0
Edon Zhegrova,xk KVX,MFFW,Lille,fr Ligue 1,22,1999,5.3,14,5,2,8,4,5,6,83.3,1,4,1,3,2,16,2,0
Luca Zidane,fr FRA,GK,Rayo Vallecano,es La Liga,23,1998,7.2,0,0,0,0,0,0,1,0.0,1,0,0,0,0,0,1,1
Piotr Zieliński,pl POL,MF,Napoli,it Serie A,27,1994,23.2,19,12,5,9,5,6,21,28.6,15,13,2,11,8,27,4,0
David Zima,cz CZE,DF,Torino,it Serie A,20,2000,14.6,20,12,8,11,1,9,20,45.0,11,15,13,2,23,43,42,0
Christoph Zimmermann,de GER,DF,Norwich City,eng Premier League,28,1993,1.7,6,3,5,1,0,3,4,75.0,1,0,0,0,1,7,4,0
Oleksandr Zinchenko,ua UKR,DF,Manchester City,eng Premier League,24,1996,11.6,20,14,7,10,3,11,20,55.0,9,11,3,8,14,34,15,1
Hakim Ziyech,ma MAR,MFFW,Chelsea,eng Premier League,28,1993,14.7,19,10,5,12,2,10,36,27.8,26,11,1,10,10,29,10,0
Jeroen Zoet,nl NED,GK,Spezia,it Serie A,30,1991,7,1,0,1,0,0,1,1,100.0,0,0,0,0,0,1,4,0
Simon Zoller,de GER,FW,Bochum,de Bundesliga,30,1991,6.6,4,2,2,1,1,1,3,33.3,2,3,0,3,4,8,2,0
Nadir Zortea,it ITA,DFMF,Salernitana,it Serie A,22,1999,15.7,21,15,9,7,5,11,19,57.9,8,14,2,12,7,28,33,0
Banhie Zoukrou,fr FRA,DF,Troyes,fr Ligue 1,18,2003,0.9,1,0,1,0,0,1,2,50.0,1,0,0,0,0,1,2,0
Kurt Zouma,fr FRA,DF,West Ham,eng Premier League,26,1994,23.1,11,6,8,3,0,4,7,57.1,3,31,26,5,34,45,132,0
Petar Zovko,ba BIH,GK,Spezia,it Serie A,19,2002,0.3,0,0,0,0,0,0,0,,0,0,0,0,0,0,1,0
Igor Zubeldia,es ESP,DF,Real Sociedad,es La Liga,24,1997,18.3,20,10,12,8,0,12,18,66.7,6,16,6,10,27,47,53,0
Martín Zubimendi,es ESP,MF,Real Sociedad,es La Liga,22,1999,28.8,52,25,19,30,3,22,44,50.0,22,30,13,17,49,101,48,1
Szymon Żurkowski,pl POL,MF,Empoli,it Serie A,23,1997,25.6,58,33,24,21,13,29,68,42.6,39,43,10,33,35,93,32,1
Martin Ødegaard,no NOR,MFFW,Arsenal,eng Premier League,22,1998,30.9,49,21,6,24,19,22,61,36.1,39,18,1,17,11,60,11,1
Milan Đurić,ba BIH,FW,Salernitana,it Serie A,31,1990,24.1,1,1,0,1,0,1,3,33.3,2,6,1,5,2,3,32,0
Filip Đuričić,rs SRB,MFFW,Sassuolo,it Serie A,29,1992,7.5,13,10,7,1,5,5,13,38.5,8,7,1,6,4,17,1,0